Bokföringsdatum;Valutadatum;Verifikationsnummer;Text;Belopp;Saldo
2025-08-21;2025-08-21;5484153245;SYSTEMBOLAGE/25-08-20;-776.000;2659.380
2025-08-21;2025-08-21;5484562512;NONNI SUSHI /25-08-20;-189.000;3435.380
2025-08-21;2025-08-21;5484016530;SL          /25-08-20;-86.000;3624.380
2025-08-20;2025-08-20;5484043648;COOP KONSUM /25-08-19;-104.850;3710.380
2025-08-20;2025-08-20;5484855520;SL          /25-08-19;-43.000;3815.230
2025-08-19;2025-08-19;5484051218;OKQ8        /25-08-17;-691.290;3858.230
2025-08-19;2025-08-19;5490990004;PETER HENELL;3000.000;4549.520
2025-08-18;2025-08-17;5484087828;COOP KONSUM /25-08-16;-177.850;1549.520
2025-08-18;2025-08-17;5484038034;SL          /25-08-16;-86.000;1727.370
2025-08-18;2025-08-17;5484611251;OLSTUGAN HOR/25-08-16;-176.000;1813.370
2025-08-18;2025-08-16;5484012058;OHLSSONS TYG/25-08-15;-1150.400;1989.370
2025-08-18;2025-08-16;5484313224;SL          /25-08-15;-43.000;3139.770
2025-08-18;2025-08-16;5490990789;46720388884;-230.000;3182.770
2025-08-18;2025-08-16;5490990789;Ö-VIKS HUSTE;-99.000;3412.770
2025-08-15;2025-08-15;5484070794;ICA NARA BER/25-08-14;-31.000;3511.770
2025-08-15;2025-08-15;5484845239;COOP KONSUM /25-08-14;-40.950;3542.770
2025-08-15;2025-08-15;5484845235;COOP KONSUM /25-08-14;-109.450;3583.720
2025-08-14;2025-08-14;5484787259;SYSTEMBOLAGE/25-08-13;-863.000;3693.170
2025-08-14;2025-08-14;5484344480;COOR POSTNOR/25-08-13;-122.000;4556.170
2025-08-14;2025-08-14;5484640378;SL          /25-08-13;-86.000;4678.170
2025-08-14;2025-08-14;5490990004;PETER HENELL;3000.000;4764.170
2025-08-13;2025-08-13;5484376728;COOP KONSUM /25-08-12;-421.960;1764.170
2025-08-12;2025-08-12;5484351255;COOP KONSUM /25-08-11;-83.400;2186.130
2025-08-12;2025-08-12;5490990789;46722419153;80.000;2269.530
2025-08-11;2025-08-11;5490990789;46722419153;-1845.000;2189.530
2025-08-11;2025-08-11;5490990004;PETER HENELL;3000.000;4034.530
2025-08-06;2025-08-06;5484283050;WEBHALLEN SV/25-08-05;-249.000;1034.530
2025-08-06;2025-08-06;5484569465;MELANDERS   /25-08-04;-290.000;1283.530
2025-08-06;2025-08-06;5484563154;BARRELS SA D/25-08-04;-156.000;1573.530
2025-08-06;2025-08-06;5484190221;SL          /25-08-05;-43.000;1729.530
2025-08-05;2025-08-05;5484718507;SL          /25-08-04;-86.000;1772.530
2025-08-04;2025-08-03;5484514326;RESTAURANGSM/25-08-02;-906.000;1858.530
2025-08-04;2025-08-02;5484390522;ICA NARA BER/25-08-01;-336.440;2764.530
2025-08-01;2025-08-01;5484035740;COOP KONSUM /25-07-31;-394.020;3100.970
2025-07-31;2025-07-31;5484448778;OKQ8        /25-07-30;-45.900;3494.990
2025-07-30;2025-07-30;5484172885;ICA NARA BER/25-07-29;-71.190;3540.890
2025-07-30;2025-07-30;5490990004;56903307478 ;-15000.000;3612.080
2025-07-28;2025-07-28;5484702512;COOP KONSUM /25-07-27;-129.050;18612.080
2025-07-28;2025-07-26;5484802108;ICA NARA BER/25-07-25;-30.000;18741.130
2025-07-25;2025-07-25;5484274855;SL          /25-07-23;-43.000;18771.130
2025-07-24;2025-07-24;5484620115;HAWAII POKE /25-07-23;-155.000;18814.130
2025-07-23;2025-07-23;5490990004;PETER HENELL;12000.000;18969.130
2025-07-22;2025-07-22;5484104005;SYSTEMBOLAGE/25-07-21;-1898.200;6969.130
2025-07-22;2025-07-22;5484164928;STORA COOP A/25-07-21;-885.970;8867.330
2025-07-21;2025-07-21;5490990004;PETER HENELL;5000.000;9753.300
2025-07-21;2025-07-21;5484656029;COOP KONSUM /25-07-20;-165.410;4753.300
2025-07-21;2025-07-21;5484656002;COOP KONSUM /25-07-20;-229.900;4918.710
2025-07-21;2025-07-21;5484615469;SL          /25-07-20;-43.000;5148.610
2025-07-21;2025-07-21;5490990004;PETER HENELL;3000.000;5191.610
2025-07-21;2025-07-20;5484333321;KATRINEHOLMS/25-07-19;-120.000;2191.610
2025-07-21;2025-07-20;5484303916;QSTAR KATRIN/25-07-19;-690.650;2311.610
2025-07-21;2025-07-20;5484324919;GRANIT 40413/25-07-20;-504.000;3002.260
2025-07-21;2025-07-19;5484374469;APOTEK HJART/25-07-18;-162.480;3506.260
2025-07-21;2025-07-19;5484833001;COOP KATRINE/25-07-18;-57.950;3668.740
2025-07-18;2025-07-18;5490990789;46768847083;-134.000;3726.690
2025-07-17;2025-07-17;5484635522;ICA SUPERMAR/25-07-16;-138.940;3860.690
2025-07-17;2025-07-17;5490990789;46768847083;-134.000;3999.630
2025-07-15;2025-07-15;5484608162;MAXI ICA STO/25-07-14;-175.700;4133.630
2025-07-14;2025-07-13;5490990789;46768847083;50.000;4309.330
2025-07-14;2025-07-13;5490990789;46704984981;50.000;4259.330
2025-07-14;2025-07-12;5484781083;OOB KATRINEH/25-07-11;-138.000;4209.330
2025-07-11;2025-07-11;5484232624;BYGGMAX KATR/25-07-10;-189.000;4347.330
2025-07-11;2025-07-11;5490990789;46768847083;-124.000;4536.330
2025-07-11;2025-07-11;5490990004;PETER HENELL;3000.000;4660.330
2025-07-10;2025-07-10;5484826355;ICA SUPERMAR/25-07-09;-374.240;1660.330
2025-07-08;2025-07-08;5484675709;MAXI ICA STO/25-07-07;-562.740;2034.570
2025-07-07;2025-07-06;5484847239;MAXI ICA STO/25-07-05;-311.530;2597.310
2025-07-07;2025-07-05;5484783594;RESTAURANGSM/25-07-02;-542.000;2908.840
2025-07-07;2025-07-05;5484119196;RESTAURANGSM/25-07-04;-158.000;3450.840
2025-07-07;2025-07-05;5484118219;PIZZERIA RUN/25-07-04;-215.000;3608.840
2025-07-07;2025-07-05;5484153391;BERGSHAMRA P/25-07-04;-120.000;3823.840
2025-07-04;2025-07-04;5484404320;COOP KONSUM /25-07-03;-68.950;3943.840
2025-07-04;2025-07-04;5484404297;COOP KONSUM /25-07-03;-20.000;4012.790
2025-07-04;2025-07-04;5484020716;SUSHI HOUSE /25-07-03;-145.000;4032.790
2025-07-01;2025-07-01;5484640149;COOP KONSUM /25-06-30;-63.450;4177.790
2025-06-30;2025-06-30;5484260784;CIRCLE K MOR/25-06-29;-69.000;4241.240
2025-06-30;2025-06-30;5490990789;46702984673;-2000.000;4310.240
2025-06-30;2025-06-29;5490990789;46708338938;149.000;6310.240
2025-06-30;2025-06-29;5490990789;46702984673;150.000;6161.240
2025-06-30;2025-06-29;5490990789;46720388884;-175.000;6011.240
2025-06-27;2025-06-27;5484765395;ALVDALENSFIS/25-06-26;-1236.000;6186.240
2025-06-27;2025-06-27;5484452502;ICA SUPERMAR/25-06-26;-143.700;7422.240
2025-06-26;2025-06-26;5484211711;MAX BURGERS /25-06-25;-127.000;7565.940
2025-06-26;2025-06-26;5484596775;COOR POSTNOR/25-06-25;-122.000;7692.940
2025-06-26;2025-06-26;5484379022;O LEARYS MOR/25-06-25;-99.000;7814.940
2025-06-26;2025-06-26;5484379021;O LEARYS MOR/25-06-25;-99.000;7913.940
2025-06-26;2025-06-26;5484878867;COOP KONSUM /25-06-25;-66.500;8012.940
2025-06-26;2025-06-26;5484820721;SL          /25-06-25;-86.000;8079.440
2025-06-26;2025-06-26;5490990789;JIGHEAD AB;-210.000;8165.440
2025-06-26;2025-06-26;5490990004;PETER HENELL;6000.000;8375.440
2025-06-25;2025-06-25;5484828292;SOEDER SPORT/25-06-24;-403.000;2375.440
2025-06-25;2025-06-25;5484269788;KERSH & HEDS/25-06-24;-139.000;2778.440
2025-06-25;2025-06-25;5484232698;BERGIS BAGER/25-06-24;-33.000;2917.440
2025-06-25;2025-06-25;5484687875;COOP KONSUM /25-06-24;-347.650;2950.440
2025-06-25;2025-06-25;5484632371;SL          /25-06-24;-86.000;3298.090
2025-06-24;2025-06-24;5484055759;ALEWALDS SPO/25-06-23;-3220.000;3384.090
2025-06-24;2025-06-24;5484494776;SL          /25-06-23;-43.000;6604.090
2025-06-23;2025-06-23;5490990004;PETER HENELL;4000.000;6647.090
2025-06-23;2025-06-21;5484553853;7-ELEVEN HOR/25-06-20;-59.000;2647.090
2025-06-23;2025-06-21;5484553837;7-ELEVEN HOR/25-06-20;-28.000;2706.090
2025-06-23;2025-06-21;5484062484;SL          /25-06-20;-86.000;2734.090
2025-06-23;2025-06-20;5484405622;COOP KONSUM /25-06-19;-30.000;2820.090
2025-06-23;2025-06-20;5484405618;COOP KONSUM /25-06-19;-349.050;2850.090
2025-06-23;2025-06-20;5484405536;COOP KONSUM /25-06-19;-23.500;3199.140
2025-06-19;2025-06-19;5484822463;PIZZERIA RUN/25-06-18;-115.000;3222.640
2025-06-19;2025-06-19;5484020176;SYSTEMBOLAGE/25-06-18;-158.000;3337.640
2025-06-17;2025-06-17;5484745379;OKQ8        /25-06-15;-362.000;3495.640
2025-06-17;2025-06-17;5484525459;ICA NARA BER/25-06-16;-31.000;3857.640
2025-06-16;2025-06-16;5484696846;COOP KONSUM /25-06-15;-113.350;3888.640
2025-06-16;2025-06-16;5490990789;SVEA BANK AB;-1747.000;4001.990
2025-06-16;2025-06-16;5490990004;PETER HENELL;2000.000;5748.990
2025-06-16;2025-06-15;5484613463;SL          /25-06-13;-86.000;3748.990
2025-06-16;2025-06-14;5484793489;RESTAURANGSM/25-06-13;-135.000;3834.990
2025-06-13;2025-06-13;5484462612;ICA NARA BER/25-06-12;-239.400;3969.990
2025-06-13;2025-06-13;5484361519;COOP KONSUM /25-06-12;-7.500;4209.390
2025-06-13;2025-06-13;5490990004;PETER HENELL;3000.000;4216.890
2025-06-12;2025-06-12;5484834094;SYSTEMBOLAGE/25-06-11;-789.000;1216.890
2025-06-12;2025-06-12;5484317891;SUSHI YAMA S/25-06-11;-180.000;2005.890
2025-06-12;2025-06-12;5484526942;SL          /25-06-11;-86.000;2185.890
2025-06-11;2025-06-11;5484538716;SYSTEMBOLAGE/25-06-10;-789.400;2271.890
2025-06-11;2025-06-11;5484383365;OKQ8        /25-06-07;-672.320;3061.290
2025-06-11;2025-06-11;5484196192;COOR POSTNOR/25-06-10;-122.000;3733.610
2025-06-11;2025-06-11;5484354972;SL          /25-06-10;-86.000;3855.610
2025-06-09;2025-06-08;5484125257;COOP KONSUM /25-06-07;-121.850;3941.610
2025-06-09;2025-06-06;5484132428;RESTAURANGSM/25-06-05;-338.000;4063.460
2025-06-09;2025-06-06;5484132423;RESTAURANGSM/25-06-05;-135.000;4401.460
2025-06-05;2025-06-05;5484447364;SL          /25-06-03;-86.000;4536.460
2025-06-05;2025-06-05;5484442519;COOP KONSUM /25-06-04;-402.030;4622.460
2025-06-04;2025-06-04;5484336286;ASPLUND PA T/25-06-03;-135.000;5024.490
2025-06-04;2025-06-04;5484732249;COOP KONSUM /25-06-03;-72.450;5159.490
2025-06-02;2025-06-02;5484088852;SODRA TEATER/25-06-01;-378.000;5231.940
2025-06-02;2025-06-02;5484088845;SODRA TEATER/25-06-01;-378.000;5609.940
2025-06-02;2025-06-02;5484088844;SODRA TEATER/25-06-01;-88.000;5987.940
2025-06-02;2025-06-02;5484548073;SL          /25-06-01;-86.000;6075.940
2025-06-02;2025-06-02;5484301281;BERGSHAMRA P/25-06-01;-115.000;6161.940
2025-06-02;2025-06-02;5490990004;PETER HENELL;5000.000;6276.940
2025-06-02;2025-05-31;5484788656;RESTAURANGSM/25-05-30;-135.000;1276.940
2025-06-02;2025-05-31;5484342568;COOP KONSUM /25-05-30;-95.530;1411.940
2025-06-02;2025-05-31;5484342531;COOP KONSUM /25-05-30;-11.500;1507.470
2025-06-02;2025-05-31;5484278918;SL          /25-05-30;-43.000;1518.970
2025-05-30;2025-05-30;5484794903;RESTAURANGSM/25-05-29;-338.000;1561.970
2025-05-26;2025-05-24;5484286971;COOP KONSUM /25-05-23;-574.490;1899.970
2025-05-23;2025-05-23;5484447540;NATURBOKHAND/25-05-22;-21.000;2474.460
2025-05-19;2025-05-19;5484406325;MILLA PIZZER/25-05-18;-160.000;2495.460
2025-05-19;2025-05-19;5484132766;HOTEL SKANSE/25-05-18;-1300.000;2655.460
2025-05-19;2025-05-19;5484055282;INGO FERJEST/25-05-18;-495.240;3955.460
2025-05-19;2025-05-19;5484658349;COOP FÄRJEST/25-05-18;-133.400;4450.700
2025-05-19;2025-05-18;5490990789;46735883291;-250.000;4584.100
2025-05-19;2025-05-18;5490990789;1235712187;-95.000;4834.100
2025-05-19;2025-05-17;5484509578;GAMMALSBYGAR/25-05-16;-1455.000;4929.100
2025-05-19;2025-05-17;5484302874;ICA SUPERMAR/25-05-16;-81.900;6384.100
2025-05-19;2025-05-17;5484302873;ICA SUPERMAR/25-05-16;-268.790;6466.000
2025-05-19;2025-05-17;5484724984;RESTAURANG F/25-05-16;-180.000;6734.790
2025-05-19;2025-05-17;5484724978;RESTAURANG F/25-05-16;-35.000;6914.790
2025-05-16;2025-05-16;5484296880;BÖDA HAMNS C/25-05-15;-7.000;6949.790
2025-05-16;2025-05-16;5484250966;ARONTORPS KR/25-05-15;-159.000;6956.790
2025-05-16;2025-05-16;5490990004;PETER HENELL;3000.000;7115.790
2025-05-15;2025-05-15;5484840731;KALK KÖK O B/25-05-14;-249.000;4115.790
2025-05-15;2025-05-15;5484408835;ICA NARA BOD/25-05-14;-231.700;4364.790
2025-05-15;2025-05-15;5484705549;SYSTEMBOLAGE/25-05-15;-903.500;4596.490
2025-05-15;2025-05-15;5490990004;PETER HENELL;3000.000;5499.990
2025-05-14;2025-05-14;5484586987;OKQ8        /25-05-13;-652.030;2499.990
2025-05-14;2025-05-14;5484371986;ICA NARA BOD/25-05-13;-41.800;3152.020
2025-05-13;2025-05-13;5484816369;OKQ8        /25-05-10;-554.080;3193.820
2025-05-13;2025-05-13;5484791463;OKQ8        /25-05-10;-402.000;3747.900
2025-05-13;2025-05-13;5484587373;ICA NARA BYX/25-05-12;-81.800;4149.900
2025-05-12;2025-05-12;5484277251;GUNTORPS HER/25-05-11;-1495.000;4231.700
2025-05-12;2025-05-12;5484840784;NATURBOKHAND/25-05-11;-319.000;5726.700
2025-05-12;2025-05-12;5484588835;ICA NARA BOD/25-05-11;-69.700;6045.700
2025-05-12;2025-05-12;5484252718;RUNSTENS PIZ/25-05-11;-163.000;6115.400
2025-05-12;2025-05-11;5484314418;ILANA RIMAS /25-05-10;-190.000;6278.400
2025-05-12;2025-05-11;5484287653;GAMLEBYS BAR/25-05-10;-110.000;6468.400
2025-05-12;2025-05-11;5484084774;ICA SUPERMAR/25-05-10;-9.950;6578.400
2025-05-12;2025-05-10;5484446103;DOWNTOWN CAM/25-05-09;-364.000;6588.350
2025-05-12;2025-05-10;5484446101;DOWNTOWN CAM/25-05-09;-364.000;6952.350
2025-05-12;2025-05-10;5484319742;ERTH HÖTORGS/25-05-09;-680.000;7316.350
2025-05-12;2025-05-10;5484198794;RESTAURANGSM/25-05-09;-292.950;7996.350
2025-05-12;2025-05-10;5484584046;SL          /25-05-09;-86.000;8289.300
2025-05-12;2025-05-10;5490990004;PETER HENELL;5000.000;8375.300
2025-05-09;2025-05-09;5484179233;COOR POSTNOR/25-05-08;-122.000;3375.300
2025-05-09;2025-05-09;5484477837;COOP KONSUM /25-05-08;-38.500;3497.300
2025-05-09;2025-05-09;5484428258;SL          /25-05-08;-86.000;3535.800
2025-05-09;2025-05-09;5484102011;RESTAURANG G/25-05-08;-176.000;3621.800
2025-05-09;2025-05-09;5484102010;RESTAURANG G/25-05-08;-346.000;3797.800
2025-05-08;2025-05-08;5484878862;ALEWALDS QUA/25-05-06;-746.000;4143.800
2025-05-08;2025-05-08;5484831853;SL          /25-05-06;-86.000;4889.800
2025-05-08;2025-05-08;5484361731;RESTAURANGSM/25-05-07;-135.000;4975.800
2025-05-07;2025-05-07;5484403652;SUSHI KOYAMA/25-05-06;-150.000;5110.800
2025-05-07;2025-05-07;5484311606;ALEWALDS SPO/25-05-06;-977.000;5260.800
2025-05-07;2025-05-07;5484306144;KRONANS APOT/25-05-06;-147.800;6237.800
2025-05-07;2025-05-07;5484289768;RESTAURANGSM/25-05-06;-135.000;6385.600
2025-05-07;2025-05-07;5484803558;COOP KONSUM /25-05-06;-17.950;6520.600
2025-05-06;2025-05-06;5484245247;RESTAURANGSM/25-05-05;-135.000;6538.550
2025-05-06;2025-05-06;5490990004;PETER HENELL;5000.000;6673.550
2025-05-05;2025-05-04;5484634828;PIZZERIA RUN/25-05-03;-120.000;1673.550
2025-05-05;2025-05-04;5484366115;ICA NARA BER/25-05-03;-25.000;1793.550
2025-05-02;2025-05-02;5484132522;OOB ARNINGE /25-04-30;-354.000;1818.550
2025-05-02;2025-05-01;5484832184;SL          /25-04-29;-86.000;2172.550
2025-05-02;2025-05-01;5484159457;STORA COOP A/25-04-30;-1112.750;2258.550
2025-05-02;2025-05-01;5484781486;COOP KONSUM /25-04-30;-98.950;3371.300
2025-04-30;2025-04-30;5484330666;ASPLUND PA T/25-04-29;-135.000;3470.250
2025-04-29;2025-04-29;5484558382;COOP KONSUM /25-04-28;-115.150;3605.250
2025-04-28;2025-04-27;5484395790;COOP KONSUM /25-04-26;-217.800;3720.400
2025-04-28;2025-04-26;5484370162;RESTAURANG S/25-04-25;-135.000;3938.200
2025-04-25;2025-04-25;5484824358;SL          /25-04-23;-86.000;4073.200
2025-04-25;2025-04-25;5484074428;ICA NARA BER/25-04-24;-30.000;4159.200
2025-04-24;2025-04-24;5484269921;KRONANS APOT/25-04-23;-51.950;4189.200
2025-04-24;2025-04-24;5484772901;COOP KONSUM /25-04-23;-349.590;4241.150
2025-04-23;2025-04-23;5484264619;OKQ8        /25-04-20;-676.030;4590.740
2025-04-23;2025-04-23;5484231048;OKQ8        /25-04-20;-175.000;5266.770
2025-04-22;2025-04-19;5484474762;SL          /25-04-18;-43.000;5441.770
2025-04-22;2025-04-19;5484265440;BERGSHAMRA P/25-04-18;-148.000;5484.770
2025-04-22;2025-04-19;5484254185;GUNNARSONS S/25-04-18;-90.000;5632.770
2025-04-22;2025-04-18;5484734763;RESTAURANG S/25-04-17;-135.000;5722.770
2025-04-22;2025-04-18;5484283957;COOP KONSUM /25-04-17;-133.140;5857.770
2025-04-22;2025-04-18;5484221748;SL          /25-04-17;-86.000;5990.910
2025-04-22;2025-04-18;5490990789;46707815940;1000.000;6076.910
2025-04-22;2025-04-18;5490990004;PETER HENELL;3000.000;5076.910
2025-04-22;2025-04-18;5490990789;46705438947;800.000;2076.910
2025-04-17;2025-04-17;5484620468;SYSTEMBOLAGE/25-04-16;-1013.900;1276.910
2025-04-17;2025-04-17;5484394849;SL          /25-04-16;-86.000;2290.810
2025-04-17;2025-04-17;5490990789;46720388884;250.000;2376.810
2025-04-16;2025-04-16;5484292380;PRESSBYRAN 4/25-04-15;-15.000;2126.810
2025-04-16;2025-04-16;5484122577;COOR POSTNOR/25-04-15;-122.000;2141.810
2025-04-16;2025-04-16;5484221813;COOP KONSUM /25-04-15;-223.330;2263.810
2025-04-16;2025-04-16;5484166074;SL          /25-04-15;-86.000;2487.140
2025-04-14;2025-04-14;5484197933;ICA NARA BER/25-04-13;-15.000;2573.140
2025-04-14;2025-04-14;5484114473;COOP KONSUM /25-04-13;-119.350;2588.140
2025-04-14;2025-04-13;5484436727;JULA SVERIGE/25-04-12;-428.800;2707.490
2025-04-14;2025-04-13;5484801361;PIZZERIA RUN/25-04-12;-140.000;3136.290
2025-04-14;2025-04-13;5484513040;ICA NARA BER/25-04-12;-51.900;3276.290
2025-04-14;2025-04-13;5484324591;JYSK HAGGVIK/25-04-12;-225.000;3328.190
2025-04-14;2025-04-12;5484460079;THE BISHOPS /25-04-11;-164.000;3553.190
2025-04-14;2025-04-12;5484460059;THE BISHOPS /25-04-11;-81.000;3717.190
2025-04-14;2025-04-12;5484572941;RESTAURANG S/25-04-11;-135.000;3798.190
2025-04-14;2025-04-12;5484125710;COOP KONSUM /25-04-11;-291.700;3933.190
2025-04-14;2025-04-12;5484063968;SL          /25-04-11;-86.000;4224.890
2025-04-11;2025-04-11;5484129550;ICA NARA BER/25-04-10;-15.000;4310.890
2025-04-10;2025-04-10;5484177005;COOR POSTNOR/25-04-09;-122.000;4325.890
2025-04-10;2025-04-10;5484616453;ICA NARA BER/25-04-09;-115.700;4447.890
2025-04-10;2025-04-10;5484459805;SL          /25-04-09;-86.000;4563.590
2025-04-09;2025-04-09;5484430955;COOP KONSUM /25-04-08;-25.000;4649.590
2025-04-09;2025-04-09;5484381710;SL          /25-04-08;-86.000;4674.590
2025-04-07;2025-04-07;5484129570;ICA NARA BER/25-04-06;-146.300;4760.590
2025-04-07;2025-04-07;5484048777;COOP KONSUM /25-04-06;-215.020;4906.890
2025-04-07;2025-04-07;5490990789;STRIPE TECHN;-2780.000;5121.910
2025-04-07;2025-04-07;5490990004;PETER HENELL;5000.000;7901.910
2025-04-07;2025-04-05;5484278043;RESTAURANG S/25-04-04;-135.000;2901.910
2025-04-07;2025-04-05;5484167869;BILIA HAGA N/25-04-04;-2124.000;3036.910
2025-04-07;2025-04-05;5484709348;COOP KONSUM /25-04-04;-40.190;5160.910
2025-04-04;2025-04-04;5484869540;COOP KONSUM /25-04-03;-190.180;5201.100
2025-04-04;2025-04-04;5484869511;COOP KONSUM /25-04-03;-52.950;5391.280
2025-04-04;2025-04-04;5490990004;PETER HENELL;3000.000;5444.230
2025-04-03;2025-04-03;5484384650;COOP KONSUM /25-04-02;-37.500;2444.230
2025-04-03;2025-04-03;5484337148;SL          /25-04-02;-86.000;2481.730
2025-04-03;2025-04-03;5484737961;ASPLUND PA T/25-04-02;-135.000;2567.730
2025-04-02;2025-04-02;5484183262;SL          /25-04-01;-86.000;2702.730
2025-03-31;2025-03-31;5490990789;PROCESSED BY;110.000;2788.730
2025-03-31;2025-03-30;5484822318;COOP KONSUM /25-03-29;-100.140;2678.730
2025-03-31;2025-03-29;5484824421;RESTAURANG S/25-03-28;-135.000;2778.870
2025-03-31;2025-03-29;5484374162;COOP KONSUM /25-03-28;-85.130;2913.870
2025-03-28;2025-03-28;5484049905;COOP KONSUM /25-03-27;-272.150;2999.000
2025-03-26;2025-03-26;5484512267;COOR POSTNOR/25-03-25;-122.000;3271.150
2025-03-26;2025-03-26;5484524610;SL          /25-03-25;-86.000;3393.150
2025-03-24;2025-03-23;5484243244;COOP KONSUM /25-03-22;-427.360;3479.150
2025-03-24;2025-03-23;5490990004;PETER HENELL;3000.000;3906.510
2025-03-24;2025-03-22;5484764477;RESTAURANG S/25-03-21;-135.000;906.510
2025-03-24;2025-03-22;5484674907;OKQ8        /25-03-21;-332.000;1041.510
2025-03-24;2025-03-22;5484340044;COOP KONSUM /25-03-21;-78.850;1373.510
2025-03-24;2025-03-22;5484340026;COOP KONSUM /25-03-21;-15.500;1452.360
2025-03-21;2025-03-21;5484647081;RESTAURANG S/25-03-20;-135.000;1467.860
2025-03-21;2025-03-21;5484275252;COOP KONSUM /25-03-20;-109.540;1602.860
2025-03-20;2025-03-20;5484056016;COOR POSTNOR/25-03-19;-122.000;1712.400
2025-03-20;2025-03-20;5484167085;SL          /25-03-19;-86.000;1834.400
2025-03-19;2025-03-19;5484438298;ICA NARA BER/25-03-18;-30.000;1920.400
2025-03-18;2025-03-18;5490990789;PROCESSED BY;-630.410;1950.400
2025-03-17;2025-03-17;5490990789;46702984673;-400.000;2580.810
2025-03-17;2025-03-15;5484482420;RESTAURANG S/25-03-14;-135.000;2980.810
2025-03-17;2025-03-15;5484178417;ICA NARA BER/25-03-14;-35.900;3115.810
2025-03-17;2025-03-15;5484070899;COOP KONSUM /25-03-14;-358.150;3151.710
2025-03-13;2025-03-13;5484629392;COOR POSTNOR/25-03-12;-122.000;3509.860
2025-03-13;2025-03-13;5484791894;SL          /25-03-12;-86.000;3631.860
2025-03-12;2025-03-12;5484421812;APOTEKSGRUPP/25-03-11;-301.330;3717.860
2025-03-12;2025-03-12;5484068769;COOP KONSUM /25-03-11;-152.850;4019.190
2025-03-10;2025-03-08;5484025936;COOP KONSUM /25-03-07;-143.750;4172.040
2025-03-07;2025-03-07;5484150673;SYSTEMBOLAGE/25-03-06;-621.000;4315.790
2025-03-07;2025-03-07;5484687932;CERVERA SVEA/25-03-06;-490.000;4936.790
2025-03-07;2025-03-07;5484561548;ALEWALDS QUA/25-03-06;-998.000;5426.790
2025-03-07;2025-03-07;5484487405;FISKELÄGET  /25-03-06;-129.000;6424.790
2025-03-07;2025-03-07;5484306780;VARSAM      /25-03-06;-100.000;6553.790
2025-03-07;2025-03-07;5484288546;SL          /25-03-06;-43.000;6653.790
2025-03-07;2025-03-07;5484562123;SYSTEMBOLAGE/25-03-07;-1204.000;6696.790
2025-03-07;2025-03-07;5490990004;PETER HENELL;5000.000;7900.790
2025-03-06;2025-03-06;5484344563;ASPLUND PA T/25-03-05;-135.000;2900.790
2025-03-06;2025-03-06;5484756586;SL          /25-03-05;-86.000;3035.790
2025-03-05;2025-03-05;5484135778;OKQ8        /25-03-02;-732.140;3121.790
2025-03-05;2025-03-05;5484184664;COOP KONSUM /25-03-04;-189.500;3853.930
2025-03-04;2025-03-04;5484427614;ICA NARA BER/25-03-03;-92.400;4043.430
2025-03-03;2025-03-02;5484716790;COOP KONSUM /25-03-01;-274.130;4135.830
2025-03-03;2025-03-02;5490990004;PETER HENELL;3000.000;4409.960
2025-03-03;2025-03-01;5484664714;RESTAURANG S/25-02-28;-135.000;1409.960
2025-03-03;2025-03-01;5484234771;COOP KONSUM /25-02-28;-14.500;1544.960
2025-02-27;2025-02-27;5484460173;ASPLUND PA T/25-02-26;-135.000;1559.460
2025-02-27;2025-02-27;5484830605;SL          /25-02-26;-86.000;1694.460
2025-02-26;2025-02-26;5484803006;COOP KONSUM /25-02-25;-324.980;1780.460
2025-02-25;2025-02-25;5484203881;RESTAURANG S/25-02-24;-135.000;2105.440
2025-02-25;2025-02-25;5484732880;COOP KONSUM /25-02-24;-14.500;2240.440
2025-02-25;2025-02-25;5484687609;SL          /25-02-24;-43.000;2254.940
2025-02-25;2025-02-25;5484480861;DOWNTOWN CAM/25-02-24;-221.000;2297.940
2025-02-24;2025-02-22;5484843800;SYSTEMBOLAGE/25-02-21;-1363.200;2518.940
2025-02-24;2025-02-22;5484857819;ICA NARA BER/25-02-21;-87.900;3882.140
2025-02-20;2025-02-20;5484389422;COOR POSTNOR/25-02-19;-122.000;3970.040
2025-02-20;2025-02-20;5484779411;COOP KONSUM /25-02-19;-532.400;4092.040
2025-02-20;2025-02-20;5484733829;SL          /25-02-19;-86.000;4624.440
2025-02-19;2025-02-19;5490990004;PETER HENELL;3000.000;4710.440
2025-02-18;2025-02-18;5484669501;NEWPORT     /25-02-17;-442.520;1710.440
2025-02-18;2025-02-18;5484637062;FRYSHUSET EV/25-02-17;-40.000;2152.960
2025-02-18;2025-02-18;5484262297;COOP KONSUM /25-02-17;-122.400;2192.960
2025-02-17;2025-02-17;5484558584;SL          /25-02-16;-86.000;2315.360
2025-02-17;2025-02-17;5484300963;SYSTEMBOLAGE/25-02-17;-437.200;2401.360
2025-02-17;2025-02-17;5490990789;46707815940;-190.000;2838.560
2025-02-17;2025-02-16;5484233889;RESTAURANG S/25-02-15;-239.000;3028.560
2025-02-14;2025-02-14;5484810682;SL          /25-02-12;-43.000;3267.560
2025-02-14;2025-02-14;5484132302;ICA NARA BER/25-02-13;-231.500;3310.560
2025-02-13;2025-02-13;5484345932;COOR POSTNOR/25-02-12;-122.000;3542.060
2025-02-11;2025-02-11;5484401017;SL          /25-02-10;-43.000;3664.060
2025-02-11;2025-02-11;5484124545;IKEA GALLERI/25-02-10;-539.000;3707.060
2025-02-10;2025-02-10;5490990004;PETER HENELL;3000.000;4246.060
2025-02-10;2025-02-08;5490990789;EVENTIM SVER;-500.000;1246.060
2025-02-10;2025-02-08;5484571660;RESTAURANG S/25-02-07;-318.000;1746.060
2025-02-10;2025-02-08;5484320405;COOP KONSUM /25-02-07;-88.470;2064.060
2025-02-07;2025-02-07;5484588161;COOR POSTNOR/25-02-06;-122.000;2152.530
2025-02-07;2025-02-07;5484132710;SL          /25-02-06;-86.000;2274.530
2025-02-06;2025-02-06;5484652903;COOR POSTNOR/25-02-05;-122.000;2360.530
2025-02-06;2025-02-06;5484820437;SL          /25-02-05;-86.000;2482.530
2025-02-05;2025-02-05;5484353326;SL          /25-02-04;-86.000;2568.530
2025-02-05;2025-02-05;5484086779;PRIME BURGER/25-02-04;-1175.900;2654.530
2025-02-04;2025-02-04;5484566105;COOP KONSUM /25-02-03;-508.130;3830.430
2025-02-04;2025-02-04;5484520772;SL          /25-02-03;-86.000;4338.560
2025-02-04;2025-02-04;5490990789;46738674668;375.000;4424.560
2025-02-04;2025-02-04;5490990789;46702883040;370.000;4049.560
2025-02-03;2025-02-03;5484795321;SL          /25-02-02;-86.000;3679.560
2025-02-03;2025-02-02;5484571637;RESTAURANG S/25-02-01;-318.000;3765.560
2025-02-03;2025-02-02;5484350210;COOP KONSUM /25-02-01;-43.740;4083.560
2025-02-03;2025-02-02;5484314027;SL          /25-02-01;-43.000;4127.300
2025-02-03;2025-02-01;5490990004;PETER HENELL;3000.000;4170.300
2025-01-31;2025-01-31;5484374397;OLD BEEFEATE/25-01-30;-512.000;1170.300
2025-01-31;2025-01-31;5484374382;OLD BEEFEATE/25-01-30;-82.000;1682.300
2025-01-31;2025-01-31;5484373089;MIKKELLER SO/25-01-30;-75.000;1764.300
2025-01-31;2025-01-31;5484050702;COOP KONSUM /25-01-30;-22.950;1839.300
2025-01-31;2025-01-31;5484876414;SL          /25-01-30;-86.000;1862.250
2025-01-30;2025-01-30;5484560435;COOR POSTNOR/25-01-29;-110.000;1948.250
2025-01-30;2025-01-30;5484071840;COOP KONSUM /25-01-29;-154.350;2058.250
2025-01-30;2025-01-30;5484024459;SL          /25-01-29;-86.000;2212.600
2025-01-30;2025-01-30;5490990789;46736227759;240.000;2298.600
2025-01-29;2025-01-29;5484286021;SL          /25-01-28;-86.000;2058.600
2025-01-28;2025-01-28;5484071542;ICA NARA BER/25-01-27;-60.000;2144.600
2025-01-27;2025-01-27;5484744625;PIZZERIA RUN/25-01-26;-260.000;2204.600
2025-01-27;2025-01-26;5484672202;COOP KONSUM /25-01-25;-75.450;2464.600
2025-01-27;2025-01-26;5484636169;SL          /25-01-25;-86.000;2540.050
2025-01-27;2025-01-25;5484354947;COOP KONSUM /25-01-24;-322.370;2626.050
2025-01-27;2025-01-25;5490990789;46720388884;-855.000;2948.420
2025-01-23;2025-01-23;5484480284;COOR POSTNOR/25-01-22;-110.000;3803.420
2025-01-22;2025-01-22;5484854617;COOP KONSUM /25-01-21;-193.660;3913.420
2025-01-22;2025-01-22;5490990789;AB STORSTOCK;-43.000;4107.080
2025-01-22;2025-01-22;5490990789;AB STORSTOCK;-43.000;4150.080
2025-01-21;2025-01-21;5490990004;PETER HENELL;3000.000;4193.080
2025-01-20;2025-01-19;5490990789;AB STORSTOCK;-43.000;1193.080
2025-01-20;2025-01-18;5484201086;COOP KONSUM /25-01-17;-478.180;1236.080
2025-01-16;2025-01-16;5484867359;COOR POSTNOR/25-01-15;-110.000;1714.260
2025-01-15;2025-01-15;5484495939;ICA NARA BER/25-01-14;-20.500;1824.260
2025-01-15;2025-01-15;5490990789;AB STORSTOCK;-43.000;1844.760
2025-01-15;2025-01-15;5490990789;AB STORSTOCK;-43.000;1887.760
2025-01-15;2025-01-15;5490990789;AB STORSTOCK;-43.000;1930.760
2025-01-13;2025-01-13;5484141517;COOP KONSUM /25-01-12;-399.580;1973.760
2025-01-13;2025-01-13;5484797694;BERGSHAMRA P/25-01-12;-125.000;2373.340
2025-01-13;2025-01-12;5484849162;RESTAURANG S/25-01-11;-433.000;2498.340
2025-01-13;2025-01-11;5490990004;PETER HENELL;2000.000;2931.340
2025-01-09;2025-01-09;5484754842;COOR POSTNOR/25-01-08;-110.000;931.340
2025-01-08;2025-01-08;5484020159;APOTEKSGRUPP/25-01-07;-40.620;1041.340
2025-01-08;2025-01-08;5484546664;COOP KONSUM /25-01-07;-118.900;1081.960
2025-01-08;2025-01-08;5490990789;AB STORSTOCK;-43.000;1200.860
2025-01-08;2025-01-08;5490990789;AB STORSTOCK;-43.000;1243.860
2025-01-07;2025-01-07;5484834511;COOP KONSUM /25-01-06;-273.360;1286.860
2025-01-07;2025-01-06;5484283423;BERGSHAMRA P/25-01-05;-142.000;1560.220
2025-01-07;2025-01-05;5484265855;ICA KVANTUM /25-01-04;-10.000;1702.220
2025-01-07;2025-01-04;5484876989;SYSTEMBOLAGE/25-01-04;-1538.000;1712.220
2025-01-07;2025-01-04;5490990004;PETER HENELL;1000.000;3250.220
2025-01-07;2025-01-04;5490990789;AB STORSTOCK;-42.000;2250.220
2025-01-02;2025-01-01;5484759927;COOP KONSUM /24-12-31;-294.460;2292.220
2025-01-02;2025-01-01;5484719723;SL          /24-12-31;-42.000;2586.680
2025-01-02;2024-12-31;5484636270;SL          /24-12-30;-42.000;2628.680
2024-12-30;2024-12-31;0000000000;RÄNTA;4.110;2670.680
2024-12-27;2024-12-26;5484385593;SL          /24-12-25;-42.000;2666.570
2024-12-27;2024-12-25;5484453355;SL          /24-12-24;-42.000;2708.570
2024-12-27;2024-12-24;5484055425;SYSTEMBOLAGE/24-12-23;-800.000;2750.570
2024-12-27;2024-12-24;5484340033;CLAS OHLSON /24-12-23;-283.800;3550.570
2024-12-27;2024-12-24;5484328095;SL          /24-12-23;-84.000;3834.370
2024-12-23;2024-12-23;5490990004;PETER HENELL;2000.000;3918.370
2024-12-23;2024-12-22;5484858134;SL          /24-12-21;-84.000;1918.370
2024-12-23;2024-12-21;5484258110;PAYPAL  STAR/24-12-20;-388.640;2002.370
2024-12-23;2024-12-21;5484258109;PAYPAL  STAR/24-12-20;-388.640;2391.010
2024-12-23;2024-12-21;5484791848;COOP KONSUM /24-12-20;-109.850;2779.650
2024-12-16;2024-12-15;5484509735;SYSTEMBOLAGE/24-12-14;-1675.000;2889.500
2024-12-16;2024-12-15;5484304820;SUSHI BAR KI/24-12-14;-145.000;4564.500
2024-12-16;2024-12-15;5484269067;COOP KONSUM /24-12-14;-172.250;4709.500
2024-12-16;2024-12-15;5484211577;SL          /24-12-14;-42.000;4881.750
2024-12-16;2024-12-14;5484558458;COOP KONSUM /24-12-13;-614.550;4923.750
2024-12-16;2024-12-14;5490990004;PETER HENELL;2000.000;5538.300
2024-12-13;2024-12-13;5484635585;RESTAURANG S/24-12-12;-135.000;3538.300
2024-12-12;2024-12-12;5484484697;RESTAURANG A/24-12-11;-32.000;3673.300
2024-12-12;2024-12-12;5484445178;NONNI SUSHI /24-12-11;-144.000;3705.300
2024-12-12;2024-12-12;5484038080;SL          /24-12-11;-126.000;3849.300
2024-12-12;2024-12-12;5484368015;THE DUBLINER/24-12-11;-252.000;3975.300
2024-12-11;2024-12-11;5484261434;7-ELEVEN 461/24-12-11;-22.000;4227.300
2024-12-10;2024-12-10;5484236966;PIZZERIA RUN/24-12-09;-275.000;4249.300
2024-12-09;2024-12-09;5484736472;BERGSHAMRA P/24-12-08;-119.000;4524.300
2024-12-05;2024-12-05;5484427784;COOR POSTNOR/24-12-04;-110.000;4643.300
2024-12-05;2024-12-05;5484077370;COOP KONSUM /24-12-04;-66.590;4753.300
2024-12-05;2024-12-05;5484040362;SL          /24-12-04;-84.000;4819.890
2024-12-04;2024-12-04;5484157377;COOP KONSUM /24-12-03;-333.970;4903.890
2024-12-02;2024-12-02;5484850670;SL          /24-12-01;-84.000;5237.860
2024-12-02;2024-12-01;5484081521;BERGSHAMRA P/24-11-30;-119.000;5321.860
2024-11-29;2024-11-29;5484732752;COOP KONSUM /24-11-28;-272.500;5440.860
2024-11-28;2024-11-28;5484583801;THE BISHOPS /24-11-27;-82.000;5713.360
2024-11-28;2024-11-28;5484070513;THE FLYING D/24-11-27;-79.000;5795.360
2024-11-28;2024-11-28;5484064755;NONNI SUSHI /24-11-27;-179.000;5874.360
2024-11-28;2024-11-28;5484540687;SL          /24-11-27;-126.000;6053.360
2024-11-27;2024-11-27;5490990789;46705979742;-500.000;6179.360
2024-11-26;2024-11-26;5490990004;PETER HENELL;6000.000;6679.360
2024-11-25;2024-11-24;5484734584;BERGSHAMRA P/24-11-22;-119.000;679.360
2024-11-25;2024-11-23;5484860324;SYSTEMBOLAGE/24-11-22;-780.000;798.360
2024-11-25;2024-11-23;5484643156;HEMKOP MORBY/24-11-22;-333.470;1578.360
2024-11-25;2024-11-23;5484597628;COOP KONSUM /24-11-22;-58.950;1911.830
2024-11-25;2024-11-23;5484535814;SL          /24-11-22;-42.000;1970.780
2024-11-22;2024-11-22;5484157513;RESTAURANG S/24-11-21;-298.000;2012.780
2024-11-22;2024-11-22;5484690028;COOP KONSUM /24-11-21;-62.570;2310.780
2024-11-20;2024-11-20;5484154591;PIZZERIA MAE/24-11-18;-140.000;2373.350
2024-11-20;2024-11-20;5484383600;COOP KONSUM /24-11-19;-260.580;2513.350
2024-11-19;2024-11-19;5484199095;ALEWALDS SPO/24-11-18;-1092.000;2773.930
2024-11-19;2024-11-19;5484712770;SL          /24-11-18;-84.000;3865.930
2024-11-18;2024-11-18;5490990004;PETER HENELL;3000.000;3949.930
2024-11-18;2024-11-16;5484174404;COOP KONSUM /24-11-15;-291.490;949.930
2024-11-18;2024-11-16;5484119360;SL          /24-11-15;-84.000;1241.420
2024-11-14;2024-11-14;5484270339;SL          /24-11-13;-84.000;1325.420
2024-11-14;2024-11-14;5484848189;COOR POSTNOR/24-11-13;-110.000;1409.420
2024-11-13;2024-11-13;5484383975;COOP KONSUM /24-11-12;-42.500;1519.420
2024-11-12;2024-11-12;5484860493;PIZZERIA RUN/24-11-11;-235.000;1561.920
2024-11-11;2024-11-11;5484649052;SL          /24-11-10;-84.000;1796.920
2024-11-11;2024-11-10;5484533398;RESTAURANG S/24-11-08;-219.000;1880.920
2024-11-07;2024-11-07;5484071780;RESTAURANG S/24-11-06;-298.000;2099.920
2024-11-05;2024-11-05;5484733627;SYSTEMBOLAGE/24-11-04;-1761.000;2397.920
2024-11-05;2024-11-05;5484659947;SL          /24-11-04;-42.000;4158.920
2024-11-04;2024-11-04;5484814140;COOP KONSUM /24-11-03;-113.000;4200.920
2024-11-04;2024-11-04;5490990004;PETER HENELL;3000.000;4313.920
2024-10-31;2024-10-31;5484601497;NONNI SUSHI /24-10-30;-179.000;1313.920
2024-10-31;2024-10-31;5484742407;COOP KONSUM /24-10-30;-87.040;1492.920
2024-10-31;2024-10-31;5484686079;SL          /24-10-30;-42.000;1579.960
2024-10-29;2024-10-29;5484695719;RG21        /24-10-28;-149.000;1621.960
2024-10-29;2024-10-29;5484323161;SL          /24-10-28;-84.000;1770.960
2024-10-28;2024-10-28;5484755544;CIRCLE K SOL/24-10-27;-251.260;1854.960
2024-10-28;2024-10-28;5484442043;SL          /24-10-27;-42.000;2106.220
2024-10-28;2024-10-27;5484876284;CIRCLE K SOL/24-10-26;-1390.000;2148.220
2024-10-28;2024-10-27;5484534732;SL          /24-10-26;-42.000;3538.220
2024-10-28;2024-10-26;5484822154;RESTAURANG S/24-10-25;-333.000;3580.220
2024-10-24;2024-10-24;5484400266;APOTEKSGRUPP/24-10-23;-764.810;3913.220
2024-10-24;2024-10-24;5484862079;SL          /24-10-23;-42.000;4678.030
2024-10-23;2024-10-23;5484443569;OKQ8        /24-10-22;-219.870;4720.030
2024-10-23;2024-10-23;5484344210;MAXI ICA STO/24-10-22;-41.950;4939.900
2024-10-23;2024-10-23;5484120901;SL          /24-10-22;-84.000;4981.850
2024-10-23;2024-10-23;5490990004;PETER HENELL;3000.000;5065.850
2024-10-21;2024-10-21;5490990789;46702984673;-900.000;2065.850
2024-10-21;2024-10-21;5484034576;MAXI ICA STO/24-10-20;-71.700;2965.850
2024-10-21;2024-10-21;5490990789;APOTEKET AB;-259.000;3037.550
2024-10-21;2024-10-19;5484236759;CHOPCHOP ROS/24-10-18;-166.000;3296.550
2024-10-18;2024-10-18;5484662504;SL          /24-10-16;-126.000;3462.550
2024-10-18;2024-10-18;5484041148;ICA NARA BER/24-10-17;-14.500;3588.550
2024-10-17;2024-10-17;5484513958;THE BISHOPS /24-10-16;-512.400;3603.050
2024-10-17;2024-10-17;5484513951;THE BISHOPS /24-10-16;-314.000;4115.450
2024-10-17;2024-10-17;5484513947;THE BISHOPS /24-10-16;-105.000;4429.450
2024-10-17;2024-10-17;5484045383;ASPLUND PA T/24-10-16;-135.000;4534.450
2024-10-17;2024-10-17;5490990789;CS-ONLINE A/;-3418.000;4669.450
2024-10-17;2024-10-17;5490990004;PETER HENELL;5000.000;8087.450
2024-10-16;2024-10-16;5490990789;46761167231;-100.000;3087.450
2024-10-16;2024-10-16;5490990004;PETER HENELL;3000.000;3187.450
2024-10-14;2024-10-12;5484747983;RESTAURANG S/24-10-11;-219.000;187.450
2024-10-14;2024-10-12;5484747977;RESTAURANG S/24-10-11;-135.000;406.450
2024-10-14;2024-10-12;5484332543;COOP KONSUM /24-10-11;-374.970;541.450
2024-10-11;2024-10-11;5484347865;SL          /24-10-09;-42.000;916.420
2024-10-10;2024-10-10;5484770185;COOR POSTNOR/24-10-09;-110.000;958.420
2024-10-08;2024-10-08;5484350336;COOP KONSUM /24-10-07;-96.900;1068.420
2024-10-07;2024-10-06;5484066386;COOP KONSUM /24-10-05;-153.300;1165.320
2024-10-07;2024-10-05;5484355183;RESTAURANG S/24-10-04;-135.000;1318.620
2024-10-07;2024-10-05;5484802622;COOP KONSUM /24-10-04;-100.900;1453.620
2024-10-03;2024-10-03;5484548219;KEBBAB KUNGE/24-10-01;-355.000;1554.520
2024-10-02;2024-10-02;5490990789;46721428359;-400.000;1909.520
2024-09-30;2024-09-30;5484561869;COOP KONSUM /24-09-29;-376.490;2309.520
2024-09-30;2024-09-30;5484218787;BERGSHAMRA P/24-09-29;-107.000;2686.010
2024-09-30;2024-09-28;5484701259;RESTAURANG S/24-09-27;-298.000;2793.010
2024-09-30;2024-09-28;5484267910;COOP KONSUM /24-09-27;-48.320;3091.010
2024-09-27;2024-09-27;5484388780;COOP KONSUM /24-09-26;-84.060;3139.330
2024-09-26;2024-09-26;5484363877;RESTAURANG A/24-09-25;-30.000;3223.390
2024-09-26;2024-09-26;5484362677;COOR POSTNOR/24-09-25;-110.000;3253.390
2024-09-24;2024-09-24;5484459778;APOTEKSGRUPP/24-09-23;-81.240;3363.390
2024-09-24;2024-09-24;5484083906;COOP KONSUM /24-09-23;-176.110;3444.630
2024-09-23;2024-09-23;5484785300;GATEAU CITY /24-09-21;-113.000;3620.740
2024-09-23;2024-09-23;5484501225;RESTAURANG K/24-09-22;-324.450;3733.740
2024-09-23;2024-09-23;5490990004;PETER HENELL;3000.000;4058.190
2024-09-23;2024-09-22;5484819122;NYNÄSHAMNS K/24-09-21;-199.000;1058.190
2024-09-23;2024-09-21;5484823006;COOP KONSUM /24-09-20;-197.900;1257.190
2024-09-23;2024-09-21;5484514642;BLIDOESUNDSB/24-09-21;-238.000;1455.090
2024-09-23;2024-09-21;5490990789;AB STORSTOCK;-104.000;1693.090
2024-09-20;2024-09-20;5484244003;COOP KONSUM /24-09-19;-8.040;1797.090
2024-09-18;2024-09-18;5490990789;46762051027;-129.000;1805.130
2024-09-17;2024-09-17;5484056170;SYSTEMBOLAGE/24-09-16;-1086.000;1934.130
2024-09-17;2024-09-17;5484066435;COOP KONSUM /24-09-16;-185.820;3020.130
2024-09-16;2024-09-14;5484417185;COOP KONSUM /24-09-13;-197.550;3205.950
2024-09-16;2024-09-14;5484417169;COOP KONSUM /24-09-13;-241.330;3403.500
2024-09-11;2024-09-11;5484624289;RESTAURANG S/24-09-10;-135.000;3644.830
2024-09-11;2024-09-11;5484275881;COOP KONSUM /24-09-10;-193.800;3779.830
2024-09-09;2024-09-09;5484494995;AH GLASSBAR /24-09-08;-110.000;3973.630
2024-09-09;2024-09-09;5484179979;BRICKYARD   /24-09-08;-176.000;4083.630
2024-09-09;2024-09-09;5484451308;RESTAURANG E/24-09-08;-233.000;4259.630
2024-09-09;2024-09-07;5484308049;BERGSHAMRA P/24-09-06;-107.000;4492.630
2024-09-06;2024-09-06;5484715562;COOP KONSUM /24-09-05;-9.500;4599.630
2024-09-05;2024-09-05;5484357161;COOP KONSUM /24-09-04;-19.000;4609.130
2024-09-05;2024-09-05;5484357101;COOP KONSUM /24-09-04;-52.950;4628.130
2024-09-04;2024-09-04;5490990789;46708338938;-1000.000;4681.080
2024-09-04;2024-09-04;5490990789;46720388884;-5000.000;5681.080
2024-09-04;2024-09-04;5490990004;PETER HENELL;9000.000;10681.080
2024-09-04;2024-09-04;5490990789;AB STORSTOCK;-1020.000;1681.080
2024-09-03;2024-09-03;5484196590;BERGSHAMRA P/24-09-02;-135.000;2701.080
2024-09-02;2024-09-02;5484547771;BODO        /24-09-01;-38.950;2836.080
2024-09-02;2024-09-02;5484517685;BODOE       /24-09-01;-45.940;2875.030
2024-09-02;2024-09-02;5484517497;GARDERMOEN  /24-09-01;-523.800;2920.970
2024-09-02;2024-08-31;5484028196;SALTSTRAUMEN/24-08-30;-198.550;3444.770
2024-08-30;2024-08-30;5484753837;BODOE       /24-08-29;-150.100;3643.320
2024-08-30;2024-08-30;5484591706;SALTSTRAUMEN/24-08-29;-2321.970;3793.420
2024-08-30;2024-08-30;5484441649;OKQ8        /24-08-28;-40.000;6115.390
2024-08-29;2024-08-29;5484523465;RESTAURANG A/24-08-28;-30.000;6155.390
2024-08-29;2024-08-29;5484522281;COOR POSTNOR/24-08-28;-110.000;6185.390
2024-08-29;2024-08-29;5490990004;PETER HENELL;5000.000;6295.390
2024-08-28;2024-08-28;5484110028;SYSTEMBOLAGE/24-08-27;-1221.600;1295.390
2024-08-27;2024-08-27;5484324275;SUSHI KOYAMA/24-08-26;-150.000;2516.990
2024-08-27;2024-08-27;5484304722;GLASSTRAPPSB/24-08-26;-65.000;2666.990
2024-08-27;2024-08-27;5484856309;COOP KONSUM /24-08-26;-51.950;2731.990
2024-08-26;2024-08-25;5484386043;RESTAURANG S/24-08-24;-294.000;2783.940
2024-08-26;2024-08-25;5484138408;COOP KONSUM /24-08-24;-84.150;3077.940
2024-08-26;2024-08-24;5484571125;BERGSHAMRA K/24-08-23;-600.000;3162.090
2024-08-26;2024-08-24;5484592727;COOP KONSUM /24-08-23;-12.950;3762.090
2024-08-26;2024-08-24;5484592632;COOP KONSUM /24-08-23;-102.650;3775.040
2024-08-26;2024-08-24;5490990004;PETER HENELL;2000.000;3877.690
2024-08-23;2024-08-23;5484700372;COOP KONSUM /24-08-22;-31.000;1877.690
2024-08-22;2024-08-22;5484278530;COOR POSTNOR/24-08-21;-110.000;1908.690
2024-08-21;2024-08-21;5484628594;COOP KONSUM /24-08-20;-90.710;2018.690
2024-08-19;2024-08-17;5484798207;COOP KONSUM /24-08-16;-394.530;2109.400
2024-08-16;2024-08-16;5484071569;OKQ8        /24-08-14;-40.000;2503.930
2024-08-16;2024-08-16;5484650747;COOP KONSUM /24-08-15;-42.500;2543.930
2024-08-15;2024-08-15;5484257319;COOR POSTNOR/24-08-14;-110.000;2586.430
2024-08-14;2024-08-14;5484849321;PRESSKLUBBEN/24-08-13;-320.250;2696.430
2024-08-14;2024-08-14;5484519838;COOP KONSUM /24-08-13;-31.000;3016.680
2024-08-13;2024-08-13;5484582077;COOP KONSUM /24-08-12;-219.200;3047.680
2024-08-13;2024-08-13;5484581983;COOP KONSUM /24-08-12;-31.000;3266.880
2024-08-13;2024-08-13;5490990789;46702214989;-120.000;3297.880
2024-08-12;2024-08-11;5484178011;COOP KONSUM /24-08-10;-264.430;3417.880
2024-08-12;2024-08-10;5484845053;COOP KONSUM /24-08-09;-31.000;3682.310
2024-08-09;2024-08-09;5484673936;COOR POSTNOR/24-08-08;-110.000;3713.310
2024-08-09;2024-08-09;5484734665;COOP KONSUM /24-08-08;-45.950;3823.310
2024-08-08;2024-08-08;5484473943;SCANDIC CONT/24-08-07;-192.000;3869.260
2024-08-08;2024-08-08;5484473935;SCANDIC CONT/24-08-07;-59.000;4061.260
2024-08-08;2024-08-08;5484407911;COOR POSTNOR/24-08-07;-110.000;4120.260
2024-08-08;2024-08-08;5490990789;46720388884;-60.000;4230.260
2024-08-07;2024-08-07;5484583873;COOP KONSUM /24-08-06;-31.000;4290.260
2024-08-07;2024-08-07;5484583813;COOP KONSUM /24-08-06;-45.900;4321.260
2024-08-06;2024-08-06;5484668616;SL          /24-08-04;-84.000;4367.160
2024-08-06;2024-08-06;5484341401;XXL SPORT & /24-08-05;-199.000;4451.160
2024-08-06;2024-08-06;5484793393;ICA NARA BER/24-08-05;-31.000;4650.160
2024-08-05;2024-08-05;5490990789;AB STORSTOCK;-1020.000;4681.160
2024-08-05;2024-08-04;5484858295;SL          /24-08-02;-84.000;5701.160
2024-08-05;2024-08-04;5484276209;COOP KONSUM /24-08-03;-301.360;5785.160
2024-08-05;2024-08-03;5484083792;MELARPAVILJO/24-08-02;-178.000;6086.520
2024-08-05;2024-08-03;5484746376;ZETTLE  KLAR/24-08-02;-170.000;6264.520
2024-08-05;2024-08-03;5484650738;PRIME BURGER/24-08-02;-290.850;6434.520
2024-08-02;2024-08-02;5484187235;ICA NARA BER/24-08-01;-25.000;6725.370
2024-07-31;2024-07-31;5484567017;OKQ8        /24-07-28;-35.000;6750.370
2024-07-30;2024-07-30;5484101368;BAUHAUS UPPS/24-07-29;-59.940;6785.370
2024-07-30;2024-07-30;5484682076;PIZZERIA RUN/24-07-29;-95.000;6845.310
2024-07-30;2024-07-30;5484500854;ICA NARA BER/24-07-29;-25.000;6940.310
2024-07-30;2024-07-30;5484459236;EKO UPPSALA /24-07-29;-19.960;6965.310
2024-07-30;2024-07-30;5490990789;46702984673;270.000;6985.270
2024-07-30;2024-07-30;5490990004;PETER HENELL;3000.000;6715.270
2024-07-29;2024-07-29;5484542675;MAXI ICA STO/24-07-28;-189.700;3715.270
2024-07-29;2024-07-29;5490990004;PETER HENELL;3000.000;3904.970
2024-07-29;2024-07-28;5484374265;SL          /24-07-26;-84.000;904.970
2024-07-29;2024-07-28;5484491259;ICA NARA BER/24-07-27;-418.700;988.970
2024-07-29;2024-07-28;5490990789;JIGHEAD AB;-100.000;1407.670
2024-07-29;2024-07-27;5484677251;SOEDER SPORT/24-07-26;-968.000;1507.670
2024-07-29;2024-07-27;5484643772;SYSTEMBOLAGE/24-07-26;-797.100;2475.670
2024-07-29;2024-07-27;5484081536;HEMKOP STOCK/24-07-26;-112.090;3272.770
2024-07-26;2024-07-26;5484213826;COOP KONSUM /24-07-25;-27.430;3384.860
2024-07-25;2024-07-25;5484636626;COOP KONSUM /24-07-24;-38.450;3412.290
2024-07-24;2024-07-24;5484016533;APOTEKSGRUPP/24-07-23;-81.240;3450.740
2024-07-24;2024-07-24;5484628172;ICA NARA BER/24-07-23;-31.000;3531.980
2024-07-24;2024-07-24;5484548058;COOP KONSUM /24-07-23;-149.430;3562.980
2024-07-22;2024-07-22;5484253755;QSTAR KATRIN/24-07-21;-789.990;3712.410
2024-07-22;2024-07-21;5484179346;MAXI ICA STO/24-07-20;-9.900;4502.400
2024-07-22;2024-07-21;5490990004;PETER HENELL;3000.000;4512.300
2024-07-22;2024-07-20;5484150928;VALLASTREETF/24-07-19;-179.000;1512.300
2024-07-22;2024-07-20;5484523814;IKEA LINKOPI/24-07-19;-17.000;1691.300
2024-07-22;2024-07-20;5484515345;BOSSES GLASS/24-07-19;-60.000;1708.300
2024-07-22;2024-07-20;5490990789;PROCESSED BY;-1614.070;1768.300
2024-07-22;2024-07-20;5490990004;PETER HENELL;2000.000;3382.370
2024-07-22;2024-07-20;5490990789;46768847083;-600.000;1382.370
2024-07-19;2024-07-19;5490990789;46704984981;-70.000;1982.370
2024-07-16;2024-07-16;5484729068;MATPIRATEN K/24-07-15;-227.560;2052.370
2024-07-15;2024-07-15;5484020827;PIZZERIA NOB/24-07-14;-109.000;2279.930
2024-07-15;2024-07-13;5484667536;ICA SUPERMAR/24-07-12;-33.950;2388.930
2024-07-12;2024-07-12;5484050415;MAXI ICA STO/24-07-11;-397.720;2422.880
2024-07-12;2024-07-12;5484050413;MAXI ICA STO/24-07-11;-392.810;2820.600
2024-07-11;2024-07-11;5490990789;46768847083;425.000;3213.410
2024-07-09;2024-07-09;5490990789;KLARNA BANK;-1087.250;2788.410
2024-07-09;2024-07-09;5490990004;PETER HENELL;2000.000;3875.660
2024-07-08;2024-07-08;5484569713;ICA SUPERMAR/24-07-07;-320.600;1875.660
2024-07-04;2024-07-04;5484346002;MAXI ICA STO/24-07-03;-814.220;2196.260
2024-07-03;2024-07-03;5484797633;PIZZERIA RUN/24-07-01;-115.000;3010.480
2024-07-03;2024-07-03;5484685430;SL          /24-07-01;-84.000;3125.480
2024-07-03;2024-07-03;5484126167;RESTAURANG S/24-07-02;-135.000;3209.480
2024-07-03;2024-07-03;5484125354;PIZZERIA RUN/24-07-02;-115.000;3344.480
2024-07-03;2024-07-03;5484719789;ICA NARA BER/24-07-02;-23.900;3459.480
2024-07-03;2024-07-03;5484633616;COOP KONSUM /24-07-02;-34.000;3483.380
2024-07-02;2024-07-02;5484449633;WALLOXEN    /24-06-28;-333.000;3517.380
2024-07-02;2024-07-02;5484540652;T-JARLEN STO/24-07-01;-31.000;3850.380
2024-07-02;2024-07-02;5484408437;ICA NARA BER/24-07-01;-20.000;3881.380
2024-07-01;2024-07-01;5484640960;COOP KONSUM /24-06-30;-31.000;3901.380
2024-07-01;2024-07-01;5484640948;COOP KONSUM /24-06-30;-34.950;3932.380
2024-07-01;2024-07-01;5490990004;PETER HENELL;3000.000;3967.330
2024-07-01;2024-06-30;5484596373;COOP KONSUM /24-06-29;-148.380;967.330
2024-07-01;2024-06-29;5484461766;NMB SMATT O /24-06-28;-71.880;1115.710
2024-07-01;2024-06-29;5484376785;THE KING S F/24-06-27;-300.000;1187.590
2024-07-01;2024-06-29;5484369908;COOP KONSUM /24-06-28;-19.000;1487.590
2024-06-28;2024-06-28;5484538069;THE DUBLINER/24-06-27;-89.000;1506.590
2024-06-28;2024-06-28;5484868236;COOP KONSUM /24-06-27;-34.000;1595.590
2024-06-28;2024-06-28;5490990789;46738674668;165.000;1629.590
2024-06-26;2024-06-26;5484611470;GLASSTRAPPSB/24-06-25;-65.000;1464.590
2024-06-26;2024-06-26;5484275979;T-JARLEN STO/24-06-25;-92.210;1529.590
2024-06-26;2024-06-26;5484130905;ICA NARA BER/24-06-25;-75.910;1621.800
2024-06-25;2024-06-25;5484182529;7-ELEVEN 401/24-06-24;-35.000;1697.710
2024-06-25;2024-06-25;5484512528;SUSHI KING  /24-06-24;-149.000;1732.710
2024-06-25;2024-06-25;5484300284;HEMKOP STOCK/24-06-24;-60.850;1881.710
2024-06-24;2024-06-24;5484406254;COOP KONSUM /24-06-23;-128.510;1942.560
2024-06-24;2024-06-24;5484406171;COOP KONSUM /24-06-23;-38.000;2071.070
2024-06-24;2024-06-24;5490990789;AB STORSTOCK;-455.000;2109.070
2024-06-24;2024-06-24;5490990789;QLIRO AB;-590.000;2564.070
2024-06-24;2024-06-23;5484500253;SL          /24-06-21;-84.000;3154.070
2024-06-24;2024-06-23;5484234523;TIME BAR    /24-06-21;-500.000;3238.070
2024-06-24;2024-06-23;5484232328;PIZZERIA RUN/24-06-22;-235.000;3738.070
2024-06-24;2024-06-23;5484830617;COOP KONSUM /24-06-22;-58.950;3973.070
2024-06-24;2024-06-22;5484427725;7-ELEVEN HOR/24-06-21;-28.000;4032.020
2024-06-24;2024-06-22;5490990004;PETER HENELL;3000.000;4060.020
2024-06-24;2024-06-21;5484751102;SL          /24-06-19;-42.000;1060.020
2024-06-24;2024-06-21;5484869963;PIZZERIA RUN/24-06-20;-120.000;1102.020
2024-06-24;2024-06-21;5484494324;ICA NARA BER/24-06-20;-45.500;1222.020
2024-06-20;2024-06-20;5484548735;SYSTEMBOLAGE/24-06-19;-447.000;1267.520
2024-06-20;2024-06-20;5484126459;COOP KONSUM /24-06-19;-23.000;1714.520
2024-06-20;2024-06-20;5490990789;46720388884;-280.000;1737.520
2024-06-20;2024-06-20;5490990789;46702984673;-610.000;2017.520
2024-06-19;2024-06-19;5484855827;BRODERNAS BO/24-06-17;-230.000;2627.520
2024-06-19;2024-06-19;5484115150;COOP KONSUM /24-06-18;-39.000;2857.520
2024-06-18;2024-06-18;5484491527;SHELL B LSTA/24-06-17;-59.000;2896.520
2024-06-18;2024-06-18;5484348595;PIZZOLOGI   /24-06-15;-150.000;2955.520
2024-06-17;2024-06-17;5490990789;1235414610;-80.000;3105.520
2024-06-17;2024-06-16;5484081515;BYGGVARUHUSE/24-06-15;-109.000;3185.520
2024-06-17;2024-06-16;5484701154;ÄLVDALENS FI/24-06-15;-1726.000;3294.520
2024-06-17;2024-06-16;5484688691;SERNA CAMPIN/24-06-15;-200.000;5020.520
2024-06-17;2024-06-16;5484572002;PREEM       /24-06-15;-30.000;5220.520
2024-06-17;2024-06-15;5484361153;RESTAURANG S/24-06-14;-298.000;5250.520
2024-06-17;2024-06-15;5484861863;HEMK P M RBY/24-06-14;-665.150;5548.520
2024-06-17;2024-06-15;5484822828;COOP KONSUM /24-06-14;-29.430;6213.670
2024-06-17;2024-06-15;5484822822;COOP KONSUM /24-06-14;-123.900;6243.100
2024-06-17;2024-06-15;5484538945;BERGSHAMRA P/24-06-13;-107.000;6367.000
2024-06-17;2024-06-15;5490990004;PETER HENELL;3000.000;6474.000
2024-06-14;2024-06-14;5484097037;SOEDER SPORT/24-06-13;-561.000;3474.000
2024-06-14;2024-06-14;5484440439;THE OLD BREW/24-06-12;-750.000;4035.000
2024-06-14;2024-06-14;5484096582;PIZZERIA RUN/24-06-13;-115.000;4785.000
2024-06-14;2024-06-14;5484057072;PIZZERIA RIM/24-06-13;-225.000;4900.000
2024-06-13;2024-06-13;5484847740;ASPLUND PA T/24-06-12;-135.000;5125.000
2024-06-13;2024-06-13;5484835446;SYSTRARNA P /24-06-12;-1525.000;5260.000
2024-06-12;2024-06-12;5484307502;COOP KONSUM /24-06-11;-19.000;6785.000
2024-06-12;2024-06-12;5490990004;PETER HENELL;5000.000;6804.000
2024-06-11;2024-06-11;5484070913;SUSHI KOYAMA/24-06-10;-130.000;1804.000
2024-06-10;2024-06-10;5484550241;COOP KONSUM /24-06-09;-125.760;1934.000
2024-06-10;2024-06-09;5484011526;COOP KONSUM /24-06-08;-118.030;2059.760
2024-06-10;2024-06-09;5484011503;COOP KONSUM /24-06-08;-46.500;2177.790
2024-06-10;2024-06-08;5484077116;OKQ8        /24-06-06;-199.000;2224.290
2024-06-10;2024-06-08;5484788447;OKQ8        /24-06-05;-48.000;2423.290
2024-06-10;2024-06-08;5484465332;COOP KONSUM /24-06-07;-36.950;2471.290
2024-06-07;2024-06-07;5484259536;ZETTLE  DALA/24-06-06;-50.000;2508.240
2024-06-07;2024-06-06;5484025134;COOR POSTNOR/24-06-05;-110.000;2558.240
2024-06-07;2024-06-06;5484447039;COOP KONSUM /24-06-05;-192.300;2668.240
2024-06-05;2024-06-05;5484714435;ZOEY S COFFE/24-06-04;-144.000;2860.540
2024-06-05;2024-06-05;5484614658;APOTEKSGRUPP/24-06-04;-1566.120;3004.540
2024-06-03;2024-06-03;5484678490;COOP KONSUM /24-06-02;-19.000;4570.660
2024-06-03;2024-06-02;5484634782;COOP KONSUM /24-06-01;-20.000;4589.660
2024-06-03;2024-06-01;5484177538;BERGIS BAGER/24-05-31;-40.000;4609.660
2024-06-03;2024-06-01;5484753901;RESTAURANG S/24-05-31;-219.000;4649.660
2024-05-31;2024-05-31;5484145700;MIXENS BAKFI/24-05-29;-490.000;4868.660
2024-05-31;2024-05-31;5484537998;OLSTUGAN HOR/24-05-30;-74.000;5358.660
2024-05-31;2024-05-31;5484537993;OLSTUGAN HOR/24-05-30;-273.000;5432.660
2024-05-31;2024-05-31;5484431795;PIZZERIA RUN/24-05-30;-120.000;5705.660
2024-05-30;2024-05-30;5484823237;SYSTEMBOLAGE/24-05-29;-242.000;5825.660
2024-05-30;2024-05-30;5484769515;7-ELEVEN 461/24-05-29;-19.000;6067.660
2024-05-30;2024-05-30;5484533507;LA GAZELLE H/24-05-29;-135.000;6086.660
2024-05-30;2024-05-30;5484169552;OKQ8        /24-05-28;-40.000;6221.660
2024-05-30;2024-05-30;5484778308;ESPRESSO H 2/24-05-29;-103.000;6261.660
2024-05-30;2024-05-30;5484506939;THE DUBLINER/24-05-29;-211.050;6364.660
2024-05-29;2024-05-29;5490990789;46738674668;366.000;6575.710
2024-05-29;2024-05-29;5490990004;PETER HENELL;5000.000;6209.710
2024-05-29;2024-05-29;5484382164;NONNI SUSHI /24-05-28;-149.000;1209.710
2024-05-29;2024-05-29;5484220920;OKQ8        /24-05-26;-860.920;1358.710
2024-05-28;2024-05-28;5484688485;COOP KONSUM /24-05-27;-96.400;2219.630
2024-05-28;2024-05-28;5484688468;COOP KONSUM /24-05-27;-104.550;2316.030
2024-05-27;2024-05-26;5484187440;MIXENS BAKFI/24-05-24;-85.000;2420.580
2024-05-27;2024-05-26;5484187438;MIXENS BAKFI/24-05-24;-80.000;2505.580
2024-05-27;2024-05-26;5484757715;BERGSHAMRA B/24-05-25;-250.000;2585.580
2024-05-27;2024-05-26;5484405014;COOP KONSUM /24-05-25;-20.000;2835.580
2024-05-27;2024-05-26;5484404914;COOP KONSUM /24-05-25;-145.410;2855.580
2024-05-27;2024-05-25;5484087827;CAFE ALMEN  /24-05-24;-50.000;3000.990
2024-05-27;2024-05-25;5484331301;RESTAURANG S/24-05-24;-219.000;3050.990
2024-05-27;2024-05-25;5484719340;COOP KONSUM /24-05-24;-17.490;3269.990
2024-05-24;2024-05-24;5484189689;PIZZERIA RUN/24-05-23;-120.000;3287.480
2024-05-24;2024-05-24;5484862308;ICA NARA BER/24-05-23;-20.000;3407.480
2024-05-23;2024-05-23;5484800186;RESTAURANG S/24-05-22;-125.000;3427.480
2024-05-23;2024-05-23;5484540805;COOP KONSUM /24-05-22;-53.450;3552.480
2024-05-22;2024-05-22;5484802144;GLASSTRAPPSB/24-05-21;-45.000;3605.930
2024-05-22;2024-05-22;5484399089;T-JARLEN STO/24-05-21;-78.900;3650.930
2024-05-21;2024-05-21;5490990004;PETER HENELL;3000.000;3729.830
2024-05-20;2024-05-20;5490990789;AB STORSTOCK;-1020.000;729.830
2024-05-20;2024-05-19;5484475239;RESTAURANG S/24-05-18;-219.000;1749.830
2024-05-20;2024-05-19;5490990789;46707411412;-25.000;1968.830
2024-05-20;2024-05-18;5484692891;RESTAURANG S/24-05-17;-125.000;1993.830
2024-05-20;2024-05-18;5484245269;COOP KONSUM /24-05-17;-31.000;2118.830
2024-05-17;2024-05-17;5484306994;T-JARLEN STO/24-05-16;-78.850;2149.830
2024-05-17;2024-05-17;5484074489;COOP KONSUM /24-05-16;-287.940;2228.680
2024-05-15;2024-05-15;5484788432;COOP KONSUM /24-05-14;-83.950;2516.620
2024-05-14;2024-05-14;5484850954;TAK         /24-05-13;-155.000;2600.570
2024-05-14;2024-05-14;5484848006;BARTERRACE  /24-05-13;-220.000;2755.570
2024-05-14;2024-05-14;5484848001;BARTERRACE  /24-05-13;-310.000;2975.570
2024-05-14;2024-05-14;5484824859;T-JARLEN STO/24-05-13;-90.560;3285.570
2024-05-13;2024-05-13;5484023778;COOP KONSUM /24-05-12;-12.900;3376.130
2024-05-13;2024-05-12;5484453293;COOP KONSUM /24-05-11;-56.450;3389.030
2024-05-13;2024-05-11;5484086538;ICA KVANTUM /24-05-10;-30.000;3445.480
2024-05-13;2024-05-11;5484022025;COOP KONSUM /24-05-10;-53.020;3475.480
2024-05-10;2024-05-10;5484549981;SYSTEMBOLAGE/24-05-10;-760.000;3528.500
2024-05-10;2024-05-09;5484366957;COOP KONSUM /24-05-08;-97.080;4288.500
2024-05-08;2024-05-08;5484714698;COOR POSTNOR/24-05-07;-110.000;4385.580
2024-05-07;2024-05-07;5484121924;T-JARLEN STO/24-05-06;-95.600;4495.580
2024-05-07;2024-05-07;5484776799;COOP KONSUM /24-05-06;-229.660;4591.180
2024-05-06;2024-05-05;5484261542;COOP KONSUM /24-05-04;-32.000;4820.840
2024-05-06;2024-05-04;5484069627;SUSHI YAMA S/24-05-03;-140.000;4852.840
2024-05-06;2024-05-04;5484453725;RESTAURANG S/24-05-03;-298.000;4992.840
2024-05-06;2024-05-04;5484045029;COOP KONSUM /24-05-03;-73.680;5290.840
2024-05-03;2024-05-03;5484685426;COOP KONSUM /24-05-02;-161.390;5364.520
2024-05-03;2024-05-03;5490990004;PETER HENELL;5000.000;5525.910
2024-05-02;2024-05-02;5484062450;PREEM       /24-05-01;-784.030;525.910
2024-04-30;2024-04-30;5490990789;1232573715;-641.000;1309.940
2024-04-29;2024-04-28;5484020695;GARDBY KAFE /24-04-27;-214.000;1950.940
2024-04-29;2024-04-27;5484419497;OKQ8        /24-04-26;-811.140;2164.940
2024-04-26;2024-04-26;5484420867;PIZZERIA RUN/24-04-25;-230.000;2976.080
2024-04-25;2024-04-25;5484530123;RESTAURANG S/24-04-24;-249.000;3206.080
2024-04-25;2024-04-25;5484177828;COOP KONSUM /24-04-24;-35.530;3455.080
2024-04-24;2024-04-24;5484875590;RESTAURANG G/24-04-23;-115.000;3490.610
2024-04-24;2024-04-24;5484646552;SYSTEMBOLAGE/24-04-24;-715.600;3605.610
2024-04-24;2024-04-24;5490990004;PETER HENELL;3000.000;4321.210
2024-04-23;2024-04-23;5484727801;RESTAURANG G/24-04-22;-140.000;1321.210
2024-04-22;2024-04-22;5484408366;COOP KONSUM /24-04-21;-180.670;1461.210
2024-04-22;2024-04-21;5484857841;AVNI AB     /24-04-19;-145.000;1641.880
2024-04-22;2024-04-20;5484774038;ROQ         /24-04-19;-341.000;1786.880
2024-04-22;2024-04-20;5484774001;ROQ         /24-04-19;-73.000;2127.880
2024-04-22;2024-04-20;5484773960;ROQ         /24-04-19;-73.000;2200.880
2024-04-19;2024-04-19;5484563188;T-JARLEN STO/24-04-18;-103.060;2273.880
2024-04-19;2024-04-19;5484429468;53 - BERGSHA/24-04-18;-1020.000;2376.940
2024-04-19;2024-04-19;5490990789;46736227759;170.000;3396.940
2024-04-18;2024-04-18;5484410454;SL          /24-04-16;-84.000;3226.940
2024-04-18;2024-04-18;5484455000;COOP KONSUM /24-04-17;-287.800;3310.940
2024-04-17;2024-04-17;5484073636;SL          /24-04-15;-84.000;3598.740
2024-04-17;2024-04-17;5484509379;T-JARLEN STO/24-04-16;-71.870;3682.740
2024-04-16;2024-04-16;5484054502;APOTEKSGRUPP/24-04-15;-257.020;3754.610
2024-04-16;2024-04-16;5484566263;COOP KONSUM /24-04-15;-69.450;4011.630
2024-04-15;2024-04-15;5484139246;PIZZERIA RUN/24-04-14;-140.000;4081.080
2024-04-15;2024-04-14;5484234185;SL          /24-04-11;-84.000;4221.080
2024-04-15;2024-04-14;5484305258;ICA NARA BER/24-04-12;-91.800;4305.080
2024-04-15;2024-04-14;5484199805;COOP KONSUM /24-04-12;-338.470;4396.880
2024-04-12;2024-04-12;5484821435;SL          /24-04-10;-84.000;4735.350
2024-04-12;2024-04-12;5484748921;T-JARLEN STO/24-04-11;-81.650;4819.350
2024-04-11;2024-04-11;5484670734;SL          /24-04-09;-84.000;4901.000
2024-04-09;2024-04-09;5484793165;COOP KONSUM /24-04-08;-186.350;4985.000
2024-04-08;2024-04-06;5484488515;SL          /24-04-04;-84.000;5171.350
2024-04-08;2024-04-06;5484484591;ICA NARA BER/24-04-05;-96.710;5255.350
2024-04-05;2024-04-05;5484470339;SL          /24-04-03;-84.000;5352.060
2024-04-05;2024-04-05;5484652724;ICA NARA BER/24-04-04;-65.800;5436.060
2024-04-04;2024-04-04;5484328521;SL          /24-04-02;-84.000;5501.860
2024-04-03;2024-04-03;5490990789;46721428359;-600.000;5585.860
2024-04-02;2024-03-31;5490990004;PETER HENELL;6000.000;6185.860
2024-04-02;2024-03-29;5484265155;COOP KONSUM /24-03-28;-583.720;185.860
2024-04-02;2024-03-29;5484265040;COOP KONSUM /24-03-27;-87.900;769.580
2024-03-28;2024-03-28;5484378791;SL          /24-03-26;-84.000;857.480
2024-03-28;2024-03-28;5484597289;RESTAURANG S/24-03-27;-298.000;941.480
2024-03-27;2024-03-27;5484019026;SL          /24-03-25;-84.000;1239.480
2024-03-27;2024-03-27;5484787192;AKADEMIBOKHA/24-03-26;-197.000;1323.480
2024-03-25;2024-03-24;5484332782;SL          /24-03-22;-42.000;1520.480
2024-03-25;2024-03-23;5484659263;SYSTEMBOLAGE/24-03-22;-1088.000;1562.480
2024-03-25;2024-03-23;5484537013;SL          /24-03-21;-84.000;2650.480
2024-03-25;2024-03-23;5484760507;RESTAURANG S/24-03-22;-298.000;2734.480
2024-03-25;2024-03-23;5484347840;COOP KONSUM /24-03-22;-14.500;3032.480
2024-03-22;2024-03-22;5484682195;PIZZERIA RUN/24-03-21;-95.000;3046.980
2024-03-21;2024-03-21;5484190932;ICA NARA BER/24-03-20;-372.880;3141.980
2024-03-21;2024-03-21;5490990004;PETER HENELL;1500.000;3514.860
2024-03-20;2024-03-20;5484450730;SL          /24-03-18;-84.000;2014.860
2024-03-20;2024-03-20;5484546887;ICA NARA BER/24-03-19;-13.900;2098.860
2024-03-19;2024-03-19;5484582934;SL          /24-03-17;-84.000;2112.760
2024-03-18;2024-03-18;5484159270;PIZZERIA RUN/24-03-17;-190.000;2196.760
2024-03-18;2024-03-17;5484090673;SL          /24-03-15;-168.000;2386.760
2024-03-18;2024-03-16;5484592823;MAN IN THE M/24-03-15;-420.000;2554.760
2024-03-18;2024-03-16;5484811731;INTERNATIONA/24-03-15;-79.000;2974.760
2024-03-15;2024-03-15;5484284630;COOP KONSUM /24-03-14;-69.450;3053.760
2024-03-14;2024-03-14;5484336807;COOP KONSUM /24-03-13;-381.200;3123.210
2024-03-11;2024-03-10;5484603335;RESTAURANG S/24-03-09;-219.000;3504.410
2024-03-11;2024-03-10;5484401561;COOP KONSUM /24-03-09;-266.750;3723.410
2024-03-11;2024-03-09;5484737230;PIZZERIA RUN/24-03-08;-215.000;3990.160
2024-03-08;2024-03-08;5484847516;PIZZERIA RUN/24-03-07;-190.000;4205.160
2024-03-08;2024-03-08;5484664166;ICA NARA BER/24-03-07;-127.300;4395.160
2024-03-07;2024-03-07;5490990004;PETER HENELL;3000.000;4522.460
2024-03-05;2024-03-05;5484627099;SYSTEMBOLAGE/24-03-04;-1825.000;1522.460
2024-03-05;2024-03-05;5484606030;COOP KONSUM /24-03-04;-267.550;3347.460
2024-03-04;2024-03-04;5490990004;PETER HENELL;3000.000;3615.010
2024-03-04;2024-03-03;5484382645;SL          /24-03-01;-84.000;615.010
2024-03-04;2024-03-02;5484347090;SL          /24-02-29;-42.000;699.010
2024-03-04;2024-03-02;5484565479;ALEWALDS SPO/24-03-01;-349.000;741.010
2024-03-04;2024-03-02;5484155332;COOP KONSUM /24-03-01;-132.400;1090.010
2024-03-01;2024-03-01;5484140516;SL          /24-02-28;-84.000;1222.410
2024-03-01;2024-03-01;5484606040;EAT BY SODEX/24-02-29;-105.000;1306.410
2024-03-01;2024-03-01;5484354361;RESTAURANG S/24-02-29;-304.000;1411.410
2024-03-01;2024-03-01;5484328341;AVNI AB     /24-02-28;-100.000;1715.410
2024-02-29;2024-02-29;5484201364;COOP KONSUM /24-02-28;-392.090;1815.410
2024-02-29;2024-02-29;5484683800;ROQ         /24-02-28;-89.000;2207.500
2024-02-28;2024-02-28;5484575879;RESTAURANG S/24-02-27;-125.000;2296.500
2024-02-26;2024-02-25;5484600190;COOP KONSUM /24-02-24;-239.600;2421.500
2024-02-26;2024-02-24;5484455439;SL          /24-02-22;-84.000;2661.100
2024-02-26;2024-02-24;5484085393;COOP KONSUM /24-02-23;-241.680;2745.100
2024-02-23;2024-02-23;5484511751;EAT BY SODEX/24-02-22;-105.000;2986.780
2024-02-22;2024-02-22;5484392077;SL          /24-02-20;-42.000;3091.780
2024-02-21;2024-02-21;5484655250;COOP KONSUM /24-02-20;-305.600;3133.780
2024-02-21;2024-02-21;5484593078;EAT BY SODEX/24-02-20;-105.000;3439.380
2024-02-21;2024-02-21;5490990789;POSTNORD SVE;-133.000;3544.380
2024-02-19;2024-02-19;5484346472;COOP KONSUM /24-02-18;-68.720;3677.380
2024-02-19;2024-02-17;5484715098;SL          /24-02-15;-126.000;3746.100
2024-02-16;2024-02-16;5484049147;EAT BY SODEX/24-02-15;-105.000;3872.100
2024-02-16;2024-02-16;5484041791;RADISSON BLU/24-02-15;-184.000;3977.100
2024-02-16;2024-02-16;5484041790;RADISSON BLU/24-02-15;-184.000;4161.100
2024-02-16;2024-02-16;5484041788;RADISSON BLU/24-02-15;-184.000;4345.100
2024-02-16;2024-02-16;5484041786;RADISSON BLU/24-02-15;-190.000;4529.100
2024-02-14;2024-02-14;5484182372;COOP KONSUM /24-02-13;-303.550;4719.100
2024-02-14;2024-02-14;5490990004;PETER HENELL;3000.000;5022.650
2024-02-12;2024-02-12;5484607470;SL          /24-02-10;-42.000;2022.650
2024-02-12;2024-02-12;5484618193;BERGSHAMRA P/24-02-11;-95.000;2064.650
2024-02-12;2024-02-11;5484413390;SYSTEMBOLAGE/24-02-10;-1302.200;2159.650
2024-02-12;2024-02-11;5484059700;SURF THELINS/24-02-10;-118.000;3461.850
2024-02-12;2024-02-10;5484436888;SL          /24-02-08;-84.000;3579.850
2024-02-12;2024-02-10;5490990004;PETER HENELL;2000.000;3663.850
2024-02-12;2024-02-10;5490990789;46702984673;-1000.000;1663.850
2024-02-09;2024-02-09;5484581588;EAT BY SODEX/24-02-08;-105.000;2663.850
2024-02-08;2024-02-08;5484611076;SL          /24-02-06;-84.000;2768.850
2024-02-07;2024-02-07;5484681290;EAT BY SODEX/24-02-06;-105.000;2852.850
2024-02-05;2024-02-04;5484500954;SL          /24-02-02;-84.000;2957.850
2024-02-05;2024-02-03;5484666870;SYSTEMBOLAGE/24-02-02;-619.000;3041.850
2024-02-05;2024-02-03;5484552347;SL          /24-02-01;-84.000;3660.850
2024-02-05;2024-02-03;5484049785;SNABBGROSS C/24-02-02;-1569.070;3744.850
2024-02-02;2024-02-02;5484239340;EAT BY SODEX/24-02-01;-105.000;5313.920
2024-02-02;2024-02-02;5490990004;PETER HENELL;5000.000;5418.920
2024-01-29;2024-01-28;5484654649;SYSTEMBOLAGE/24-01-27;-934.400;418.920
2024-01-29;2024-01-27;5484698196;SL          /24-01-25;-84.000;1353.320
2024-01-29;2024-01-27;5484706346;PIZZERIA RUN/24-01-26;-264.000;1437.320
2024-01-29;2024-01-27;5484458944;ICA NARA BER/24-01-26;-473.310;1701.320
2024-01-26;2024-01-26;5484798230;COOP KONSUM /24-01-25;-135.350;2174.630
2024-01-26;2024-01-26;5484731245;EAT BY SODEX/24-01-25;-105.000;2309.980
2024-01-23;2024-01-23;5484546117;APOTEKSGRUPP/24-01-22;-16.260;2414.980
2024-01-23;2024-01-23;5484218488;COOP KONSUM /24-01-22;-109.450;2431.240
2024-01-22;2024-01-20;5484467712;SL          /24-01-18;-84.000;2540.690
2024-01-22;2024-01-20;5484714319;RESTAURANG S/24-01-19;-298.000;2624.690
2024-01-22;2024-01-20;5484318908;COOP KONSUM /24-01-19;-89.780;2922.690
2024-01-19;2024-01-19;5484574089;EAT BY SODEX/24-01-18;-105.000;3012.470
2024-01-18;2024-01-18;5484592359;SL          /24-01-16;-84.000;3117.470
2024-01-17;2024-01-17;5484191144;EAT BY SODEX/24-01-16;-105.000;3201.470
2024-01-16;2024-01-16;5484602762;OKQ8        /24-01-14;-158.000;3306.470
2024-01-16;2024-01-16;5484357860;COOP KONSUM /24-01-15;-104.900;3464.470
2024-01-16;2024-01-16;5484357815;COOP KONSUM /24-01-15;-348.960;3569.370
2024-01-15;2024-01-15;5484598868;SL          /24-01-13;-126.000;3918.330
2024-01-15;2024-01-14;5484400843;SOEDER SPORT/24-01-13;-581.000;4044.330
2024-01-15;2024-01-14;5484287403;SL          /24-01-12;-42.000;4625.330
2024-01-15;2024-01-14;5484183817;OLSTUGAN HOR/24-01-13;-276.150;4667.330
2024-01-15;2024-01-14;5490990789;JIGHEAD AB;-200.000;4943.480
2024-01-15;2024-01-13;5484486834;SCANDIC ANGL/24-01-12;-291.000;5143.480
2024-01-15;2024-01-13;5484151705;MAN IN THE M/24-01-12;-280.000;5434.480
2024-01-15;2024-01-13;5484681123;COOP KONSUM /24-01-12;-20.000;5714.480
2024-01-15;2024-01-13;5484275598;HIRSCHENKELL/24-01-12;-49.000;5734.480
2024-01-15;2024-01-13;5490990004;PETER HENELL;4000.000;5783.480
2024-01-12;2024-01-12;5484679443;SL          /24-01-10;-84.000;1783.480
2024-01-12;2024-01-12;5490990789;46705438947;-230.000;1867.480
2024-01-11;2024-01-11;5484174037;COOP KONSUM /24-01-10;-209.170;2097.480
2024-01-09;2024-01-09;5484561770;COOP KONSUM /24-01-08;-327.840;2306.650
2024-01-09;2024-01-09;5490990789;46702622386;-100.000;2634.490
2024-01-08;2024-01-06;5484142779;SL          /24-01-04;-42.000;2734.490
2024-01-05;2024-01-05;5484451375;SYSTEMBOLAGE/24-01-04;-395.000;2776.490
2024-01-05;2024-01-05;5484764839;HEMKOP MORBY/24-01-04;-199.750;3171.490
2024-01-03;2024-01-03;5484111180;COOP KONSUM /24-01-02;-268.350;3371.240
2024-01-02;2024-01-01;5484633105;COOP KONSUM /23-12-31;-64.950;3639.590
2024-01-02;2024-01-01;5484633103;COOP KONSUM /23-12-31;-204.850;3704.540
2024-01-02;2023-12-30;5484233515;SL          /23-12-28;-39.000;3909.390
2023-12-29;2023-12-31;0000000000;RÄNTA;4.020;3948.390
2023-12-29;2023-12-29;5484366502;SYSTEMBOLAGE/23-12-28;-1267.400;3944.370
2023-12-29;2023-12-29;5484258023;COOP KONSUM /23-12-28;-452.540;5211.770
2023-12-28;2023-12-28;5490990004;PETER HENELL;3000.000;5664.310
2023-12-27;2023-12-27;5484164955;SL          /23-12-25;-39.000;2664.310
2023-12-27;2023-12-24;5484024243;SL          /23-12-22;-156.000;2703.310
2023-12-27;2023-12-24;5490990789;46760450519;-4000.000;2859.310
2023-12-27;2023-12-23;5484776312;THE BISHOPS /23-12-22;-194.000;6859.310
2023-12-27;2023-12-23;5484776307;THE BISHOPS /23-12-22;-97.000;7053.310
2023-12-27;2023-12-23;5484317485;FISKELÄGET  /23-12-22;-1180.000;7150.310
2023-12-27;2023-12-23;5484648016;LOBBY       /23-12-22;-702.900;8330.310
2023-12-22;2023-12-22;5484797771;COOP KONSUM /23-12-21;-322.320;9033.210
2023-12-22;2023-12-22;5490990789;46738674668;320.000;9355.530
2023-12-22;2023-12-22;5490990004;PETER HENELL;5000.000;9035.530
2023-12-21;2023-12-21;5484540583;COOP KONSUM /23-12-20;-118.630;4035.530
2023-12-20;2023-12-20;5484602922;APOTEKSGRUPP/23-12-18;-16.260;4154.160
2023-12-20;2023-12-20;5490990004;PETER HENELL;3000.000;4170.420
2023-12-19;2023-12-19;5484558685;RESTAURANG S/23-12-18;-125.000;1170.420
2023-12-18;2023-12-17;5484469093;SL          /23-12-15;-78.000;1295.420
2023-12-18;2023-12-16;5484596184;SL          /23-12-14;-78.000;1373.420
2023-12-15;2023-12-15;5484597922;EAT BY SODEX/23-12-14;-99.000;1451.420
2023-12-14;2023-12-14;5484311990;SL          /23-12-12;-39.000;1550.420
2023-12-14;2023-12-14;5484436136;COOP KONSUM /23-12-13;-208.800;1589.420
2023-12-13;2023-12-13;5484554572;SL          /23-12-11;-78.000;1798.220
2023-12-13;2023-12-13;5484214010;SYSTRARNA P /23-12-12;-1187.500;1876.220
2023-12-13;2023-12-13;5484155413;PIZZERIA RUN/23-12-12;-110.000;3063.720
2023-12-12;2023-12-12;5484557520;THE BISHOPS /23-12-11;-164.000;3173.720
2023-12-12;2023-12-12;5484268182;HAYMARKET BY/23-12-11;-385.000;3337.720
2023-12-11;2023-12-10;5484040735;SL          /23-12-08;-78.000;3722.720
2023-12-11;2023-12-10;5484433385;VACCINDIREKT/23-12-08;-450.000;3800.720
2023-12-11;2023-12-09;5484065794;SYSTEMBOLAGE/23-12-08;-401.000;4250.720
2023-12-11;2023-12-09;5484800847;SL          /23-12-07;-156.000;4651.720
2023-12-11;2023-12-09;5484320525;MICKES SERIE/23-12-08;-390.000;4807.720
2023-12-08;2023-12-08;5490990004;PETER HENELL;3000.000;5197.720
2023-12-07;2023-12-07;5490990789;46705438947;-500.000;2197.720
2023-12-07;2023-12-07;5484123026;SL          /23-12-05;-78.000;2697.720
2023-12-06;2023-12-06;5484396511;6434 ARENAST/23-12-05;-102.000;2775.720
2023-12-04;2023-12-03;5484612218;ICA NARA BER/23-12-02;-503.330;2877.720
2023-12-04;2023-12-03;5490990789;46720388884;-4768.000;3381.050
2023-12-04;2023-12-03;5490990004;PETER HENELL;5000.000;8149.050
2023-12-04;2023-12-02;5484792497;RESTAURANG S/23-12-01;-219.000;3149.050
2023-11-30;2023-11-30;5484758698;RESTAURANG S/23-11-29;-125.000;3368.050
2023-11-30;2023-11-30;5484413992;COOP KONSUM /23-11-29;-241.090;3493.050
2023-11-30;2023-11-30;5490990789;1235010822;-1300.000;3734.140
2023-11-28;2023-11-28;5484585528;OKQ8        /23-11-26;-583.320;5034.140
2023-11-27;2023-11-25;5484398294;PIZZERIA RUN/23-11-24;-220.000;5617.460
2023-11-27;2023-11-25;5484819088;COOP KONSUM /23-11-24;-35.900;5837.460
2023-11-24;2023-11-24;5490990004;PETER HENELL;5000.000;5873.360
2023-11-21;2023-11-21;5484334487;PIZZERIA RUN/23-11-20;-130.000;873.360
2023-11-20;2023-11-20;5484454298;COOP KONSUM /23-11-19;-89.400;1003.360
2023-11-20;2023-11-19;5484571366;SL          /23-11-17;-39.000;1092.760
2023-11-20;2023-11-19;5484753412;COOP KONSUM /23-11-18;-184.960;1131.760
2023-11-20;2023-11-18;5484780884;SYSTEMBOLAGE/23-11-17;-850.000;1316.720
2023-11-20;2023-11-18;5484682715;HEMKOP MORBY/23-11-17;-313.760;2166.720
2023-11-20;2023-11-18;5484447645;COOP KONSUM /23-11-17;-69.990;2480.480
2023-11-17;2023-11-17;5484489909;SL          /23-11-15;-117.000;2550.470
2023-11-16;2023-11-16;5484641294;EAT BY SODEX/23-11-15;-99.000;2667.470
2023-11-16;2023-11-16;5484327576;INTERNATIONA/23-11-15;-117.000;2766.470
2023-11-16;2023-11-16;5490990789;46739209405;175.000;2883.470
2023-11-15;2023-11-15;5484509406;SL          /23-11-13;-78.000;2708.470
2023-11-15;2023-11-15;5484672401;COOP KONSUM /23-11-14;-128.740;2786.470
2023-11-15;2023-11-15;5490990789;46761510662;-50.000;2915.210
2023-11-14;2023-11-14;5484751371;PUB ANCHOR  /23-11-12;-1073.600;2965.210
2023-11-14;2023-11-14;5484616838;SCM SE 50   /23-11-12;-450.000;4038.810
2023-11-14;2023-11-14;5484581957;FRYSHUSET EV/23-11-12;-40.000;4488.810
2023-11-14;2023-11-14;5484308661;SL          /23-11-12;-117.000;4528.810
2023-11-14;2023-11-14;5484459115;EAT BY SODEX/23-11-13;-99.000;4645.810
2023-11-14;2023-11-14;5484830742;SL          /23-11-10;-78.000;4744.810
2023-11-13;2023-11-13;5490990789;SVEA BANK AB;-1103.000;4822.810
2023-11-13;2023-11-13;5490990004;PETER HENELL;3000.000;5925.810
2023-11-13;2023-11-12;5490990789;46707591203;300.000;2925.810
2023-11-13;2023-11-12;5490990789;1235880695;-120.000;2625.810
2023-11-13;2023-11-12;5490990789;46729025611;100.000;2745.810
2023-11-13;2023-11-11;5484760378;RESTAURANG S/23-11-10;-125.000;2645.810
2023-11-13;2023-11-11;5484730968;URBAN DELI S/23-11-10;-246.000;2770.810
2023-11-13;2023-11-11;5484730960;URBAN DELI S/23-11-10;-82.000;3016.810
2023-11-13;2023-11-11;5484718394;MAN IN THE M/23-11-10;-330.000;3098.810
2023-11-13;2023-11-11;5484361257;COOP KONSUM /23-11-10;-68.500;3428.810
2023-11-10;2023-11-10;5484484872;SL          /23-11-08;-78.000;3497.310
2023-11-10;2023-11-10;5484064157;PIZZERIA RUN/23-11-09;-110.000;3575.310
2023-11-10;2023-11-10;5484595254;COOP KONSUM /23-11-09;-28.950;3685.310
2023-11-10;2023-11-10;5490990004;PETER HENELL;3000.000;3714.260
2023-11-09;2023-11-09;5484315350;SL          /23-11-07;-78.000;714.260
2023-11-09;2023-11-09;5484190556;DOWNTOWN CAM/23-11-08;-152.000;792.260
2023-11-08;2023-11-08;5490990789;46705651833;-240.000;944.260
2023-11-08;2023-11-08;5490990789;46705979742;-600.000;1184.260
2023-11-08;2023-11-08;5484396048;SL          /23-11-06;-78.000;1784.260
2023-11-08;2023-11-08;5484369293;EAT BY SODEX/23-11-07;-99.000;1862.260
2023-11-07;2023-11-07;5484216848;OLD BEEFEATE/23-11-06;-176.000;1961.260
2023-11-07;2023-11-07;5484216847;OLD BEEFEATE/23-11-06;-136.000;2137.260
2023-11-06;2023-11-06;5484054427;BERGSHAMRA P/23-11-04;-149.000;2273.260
2023-11-06;2023-11-06;5484676359;STIGBERGETS /23-11-03;-800.000;2422.260
2023-11-06;2023-11-06;5484425363;SL          /23-11-04;-39.000;3222.260
2023-11-06;2023-11-05;5484630502;SL          /23-11-03;-78.000;3261.260
2023-11-06;2023-11-05;5484167382;MORFAR GINKO/23-11-03;-99.000;3339.260
2023-11-06;2023-11-05;5484167377;MORFAR GINKO/23-11-03;-197.000;3438.260
2023-11-06;2023-11-04;5484785353;RESTAURANG S/23-11-03;-125.000;3635.260
2023-11-06;2023-11-04;5484750728;OLD BEEFEATE/23-11-03;-208.000;3760.260
2023-11-06;2023-11-04;5484750727;OLD BEEFEATE/23-11-03;-90.000;3968.260
2023-11-06;2023-11-04;5484750720;OLD BEEFEATE/23-11-03;-164.000;4058.260
2023-11-06;2023-11-04;5484750692;OLD BEEFEATE/23-11-03;-96.000;4222.260
2023-11-06;2023-11-04;5484402421;COOP KONSUM /23-11-03;-49.950;4318.260
2023-11-03;2023-11-03;5484700436;RESTAURANG S/23-11-02;-125.000;4368.210
2023-11-03;2023-11-03;5484346560;COOP KONSUM /23-11-02;-54.900;4493.210
2023-11-03;2023-11-03;5490990789;46736227759;400.000;4548.110
2023-11-02;2023-11-02;5484185324;COOP KONSUM /23-11-01;-91.900;4148.110
2023-11-01;2023-11-01;5484012485;SL          /23-10-30;-39.000;4240.010
2023-11-01;2023-11-01;5484278242;RESTAURANG S/23-10-31;-125.000;4279.010
2023-11-01;2023-11-01;5484802188;COOP KONSUM /23-10-31;-209.260;4404.010
2023-10-31;2023-10-31;5484626397;EAT BY SODEX/23-10-30;-99.000;4613.270
2023-10-30;2023-10-30;5484263677;COOP KONSUM /23-10-29;-143.500;4712.270
2023-10-30;2023-10-29;5484428533;SL          /23-10-27;-78.000;4855.770
2023-10-30;2023-10-29;5484403501;COOP KONSUM /23-10-28;-64.950;4933.770
2023-10-30;2023-10-28;5484545789;SL          /23-10-26;-39.000;4998.720
2023-10-30;2023-10-28;5484059536;EAT BY SODEX/23-10-26;-99.000;5037.720
2023-10-30;2023-10-28;5484625534;RESTAURANG S/23-10-27;-324.000;5136.720
2023-10-26;2023-10-26;5490990004;PETER HENELL;5000.000;5460.720
2023-10-25;2023-10-25;5484195340;SL          /23-10-23;-39.000;460.720
2023-10-25;2023-10-25;5484273369;EAT BY SODEX/23-10-23;-99.000;499.720
2023-10-24;2023-10-24;5484268520;ICA NARA BER/23-10-23;-17.900;598.720
2023-10-23;2023-10-22;5484302593;LILLA ROSA P/23-10-21;-175.000;616.620
2023-10-23;2023-10-22;5490990789;46708338938;-500.000;791.620
2023-10-23;2023-10-22;5490990789;46720388884;-500.000;1291.620
2023-10-23;2023-10-22;5490990789;1231161348;-60.000;1791.620
2023-10-23;2023-10-21;5484031733;SL          /23-10-19;-39.000;1851.620
2023-10-23;2023-10-21;5484532715;BILTEMA SWED/23-10-20;-206.000;1890.620
2023-10-23;2023-10-21;5484472591;PIZZERIA RUN/23-10-20;-110.000;2096.620
2023-10-23;2023-10-21;5490990789;1230554808;-180.000;2206.620
2023-10-20;2023-10-20;5484865137;SCALA TEATER/23-10-18;-300.000;2386.620
2023-10-20;2023-10-20;5484833313;SL          /23-10-18;-39.000;2686.620
2023-10-19;2023-10-19;5484859070;SL          /23-10-17;-39.000;2725.620
2023-10-19;2023-10-19;5484599141;SODER SPORTF/23-10-17;-3552.000;2764.620
2023-10-19;2023-10-19;5484613258;THE DUBLINER/23-10-18;-86.000;6316.620
2023-10-18;2023-10-18;5490990789;46705438947;-480.000;6402.620
2023-10-17;2023-10-17;5490990004;PETER HENELL;3000.000;6882.620
2023-10-17;2023-10-17;5490990004;PETER HENELL;3000.000;3882.620
2023-10-17;2023-10-17;5490990789;POSTNORD SVE;-967.000;882.620
2023-10-16;2023-10-15;5484266910;PIZZERIA RUN/23-10-14;-115.000;1849.620
2023-10-16;2023-10-14;5484764084;SL          /23-10-12;-39.000;1964.620
2023-10-13;2023-10-13;5484016261;SL          /23-10-11;-78.000;2003.620
2023-10-13;2023-10-13;5484811456;SYSTEMBOLAGE/23-10-12;-747.000;2081.620
2023-10-13;2023-10-13;5484259678;HEMKOP MORBY/23-10-12;-779.030;2828.620
2023-10-12;2023-10-12;5484389203;KMARKT CENTR/23-10-11;-140.000;3607.650
2023-10-11;2023-10-11;5484038934;OKQ8        /23-10-08;-966.700;3747.650
2023-10-10;2023-10-10;5484475807;APOTEKSGRUPP/23-10-09;-457.860;4714.350
2023-10-10;2023-10-10;5484189928;ICA NARA BER/23-10-09;-24.900;5172.210
2023-10-09;2023-10-09;5484662276;CAFE KARTORP/23-10-08;-210.000;5197.110
2023-10-09;2023-10-09;5490990004;PETER HENELL;3000.000;5407.110
2023-10-09;2023-10-08;5490990789;46702883040;-1070.000;2407.110
2023-10-06;2023-10-06;5484873425;CHOPCHOP NYK/23-10-05;-133.000;3477.110
2023-10-06;2023-10-06;5484823854;OKQ8        /23-10-05;-761.120;3610.110
2023-10-06;2023-10-06;5484476710;4015 OLEARYS/23-10-04;-314.000;4371.230
2023-10-05;2023-10-05;5490990004;PETER HENELL;3000.000;4685.230
2023-10-04;2023-10-04;5484247806;SL          /23-10-02;-117.000;1685.230
2023-10-04;2023-10-04;5484134664;SCANDIC PLAZ/23-10-03;-1576.000;1802.230
2023-10-04;2023-10-04;5484134659;SCANDIC PLAZ/23-10-03;-103.000;3378.230
2023-10-04;2023-10-04;5484700388;LA COPITA RE/23-10-03;-600.000;3481.230
2023-10-04;2023-10-04;5484572978;RC ARLANDA T/23-10-03;-39.000;4081.230
2023-10-04;2023-10-04;5484431130;ICA CITY CEN/23-10-03;-35.150;4120.230
2023-10-04;2023-10-04;5484349820;EAT BY SODEX/23-10-02;-99.000;4155.380
2023-10-04;2023-10-04;5490990789;1236931133;-109.000;4254.380
2023-10-04;2023-10-04;5490990004;PETER HENELL;1000.000;4363.380
2023-10-03;2023-10-03;5484782120;SHERATON STO/23-10-02;-86.000;3363.380
2023-10-03;2023-10-03;5490990789;46702622386;-145.000;3449.380
2023-10-03;2023-10-03;5490990789;46702414266;-150.000;3594.380
2023-10-02;2023-10-01;5484572590;SL          /23-09-29;-78.000;3744.380
2023-10-02;2023-10-01;5484255642;MORFAR GINKO/23-09-29;-98.000;3822.380
2023-10-02;2023-10-01;5484255609;MORFAR GINKO/23-09-29;-900.000;3920.380
2023-09-29;2023-09-29;5490990789;46736227759;300.000;4820.380
2023-09-29;2023-09-29;5490990789;46704841061;300.000;4520.380
2023-09-29;2023-09-29;5484450621;SL          /23-09-27;-39.000;4220.380
2023-09-29;2023-09-29;5484401246;EAT BY SODEX/23-09-27;-99.000;4259.380
2023-09-27;2023-09-27;5484039085;SL          /23-09-25;-39.000;4358.380
2023-09-27;2023-09-27;5484032805;EAT BY SODEX/23-09-25;-99.000;4397.380
2023-09-27;2023-09-27;5490990789;POSTNORD SVE;-173.000;4496.380
2023-09-26;2023-09-26;5490990789;46702622386;300.000;4669.380
2023-09-26;2023-09-26;5490990004;PETER HENELL;2000.000;4369.380
2023-09-25;2023-09-25;5484132921;SL          /23-09-23;-78.000;2369.380
2023-09-25;2023-09-25;5484612900;PLANTAGEN FR/23-09-24;-717.400;2447.380
2023-09-25;2023-09-25;5484293602;COOP KONSUM /23-09-24;-139.240;3164.780
2023-09-25;2023-09-24;5484765418;BERGSHAMRA B/23-09-23;-250.000;3304.020
2023-09-25;2023-09-24;5484822244;THE DUBLINER/23-09-23;-378.400;3554.020
2023-09-25;2023-09-24;5484822216;THE DUBLINER/23-09-23;-85.000;3932.420
2023-09-25;2023-09-24;5484822177;THE DUBLINER/23-09-23;-85.000;4017.420
2023-09-25;2023-09-24;5490990789;STOCKHOLMS S;-15.000;4102.420
2023-09-25;2023-09-23;5484642333;PIZZERIA RUN/23-09-22;-110.000;4117.420
2023-09-22;2023-09-22;5490990789;46739209405;300.000;4227.420
2023-09-21;2023-09-21;5484271918;COOP KONSUM /23-09-20;-217.960;3927.420
2023-09-20;2023-09-20;5484077583;M/S ECKERO  /23-09-19;-707.000;4145.380
2023-09-20;2023-09-20;5484077579;M/S ECKERO  /23-09-19;-116.600;4852.380
2023-09-19;2023-09-19;5484810335;OKQ8        /23-09-16;-686.050;4968.980
2023-09-19;2023-09-19;5490990789;46733426457;-60.000;5655.030
2023-09-19;2023-09-19;5490990789;46702622386;-150.000;5715.030
2023-09-18;2023-09-18;5484359736;M/S ECKERO  /23-09-17;-129.000;5865.030
2023-09-18;2023-09-18;5484359731;M/S ECKERO  /23-09-17;-269.000;5994.030
2023-09-18;2023-09-18;5490990789;46727249462;-405.000;6263.030
2023-09-18;2023-09-17;5484777933;EAT BY SODEX/23-09-15;-99.000;6668.030
2023-09-18;2023-09-16;5484055824;SL          /23-09-14;-39.000;6767.030
2023-09-18;2023-09-16;5484118654;EAT BY SODEX/23-09-14;-99.000;6806.030
2023-09-18;2023-09-16;5490990004;PETER HENELL;3000.000;6905.030
2023-09-15;2023-09-15;5484093477;COOP KONSUM /23-09-14;-54.450;3905.030
2023-09-14;2023-09-14;5484463492;PIZZERIA RUN/23-09-13;-230.000;3959.480
2023-09-13;2023-09-13;5484054859;SL          /23-09-11;-39.000;4189.480
2023-09-13;2023-09-13;5484126340;EAT BY SODEX/23-09-11;-99.000;4228.480
2023-09-11;2023-09-11;5484340279;SL          /23-09-09;-39.000;4327.480
2023-09-11;2023-09-10;5484666684;SL          /23-09-08;-39.000;4366.480
2023-09-11;2023-09-10;5490990789;46720388884;200.000;4405.480
2023-09-11;2023-09-09;5484809834;EAT BY SODEX/23-09-07;-99.000;4205.480
2023-09-07;2023-09-07;5484728600;APOTEKSGRUPP/23-09-06;-117.900;4304.480
2023-09-07;2023-09-07;5484378567;COOP KONSUM /23-09-06;-18.900;4422.380
2023-09-04;2023-09-04;5484400672;MAMMA MOS   /23-09-03;-139.000;4441.280
2023-09-04;2023-09-04;5490990789;46702984673;-400.000;4580.280
2023-09-04;2023-09-03;5490990789;JIGHEAD AB;-140.000;4980.280
2023-09-04;2023-09-02;5484050344;SL          /23-08-31;-39.000;5120.280
2023-09-04;2023-09-02;5484852273;CITY GROSS G/23-09-01;-122.800;5159.280
2023-09-01;2023-09-01;5484661623;SL          /23-08-30;-39.000;5282.080
2023-09-01;2023-09-01;5484385202;SODER SPORTF/23-08-30;-586.000;5321.080
2023-09-01;2023-09-01;5484363149;STAGE       /23-08-30;-282.000;5907.080
2023-09-01;2023-09-01;5484350425;INDIAN PLAZA/23-08-31;-110.000;6189.080
2023-09-01;2023-09-01;5484036588;HEMKOP MORBY/23-08-31;-429.090;6299.080
2023-09-01;2023-09-01;5490990789;JIGHEAD AB;-800.000;6728.170
2023-08-31;2023-08-31;5484092363;ZETTLE  PANG/23-08-30;-125.000;7528.170
2023-08-31;2023-08-31;5484269143;COOP KONSUM /23-08-30;-29.900;7653.170
2023-08-31;2023-08-31;5490990004;PETER HENELL;5000.000;7683.070
2023-08-30;2023-08-30;5484461154;EAT BY SODEX/23-08-28;-99.000;2683.070
2023-08-29;2023-08-29;5484828477;STORA VIKING/23-08-26;-194.000;2782.070
2023-08-29;2023-08-29;5484817808;FROSUNDA SPO/23-08-28;-148.000;2976.070
2023-08-29;2023-08-29;5490990789;BÄTTRE HÄLSA;-590.000;3124.070
2023-08-28;2023-08-28;5484550677;SL          /23-08-26;-78.000;3714.070
2023-08-28;2023-08-28;5484671435;COOP KONSUM /23-08-27;-229.700;3792.070
2023-08-28;2023-08-27;5484163737;GLADA STINSE/23-08-26;-247.000;4021.770
2023-08-28;2023-08-27;5484163733;GLADA STINSE/23-08-26;-193.000;4268.770
2023-08-28;2023-08-26;5490990789;46707815940;69.000;4461.770
2023-08-28;2023-08-26;5490990789;46736227759;-229.000;4392.770
2023-08-23;2023-08-23;5484673515;AMIRAS      /23-08-21;-287.000;4621.770
2023-08-23;2023-08-23;5484323297;EAT BY SODEX/23-08-21;-99.000;4908.770
2023-08-21;2023-08-20;5484454355;THE DOORS   /23-08-18;-98.000;5007.770
2023-08-21;2023-08-20;5484454330;THE DOORS   /23-08-18;-203.000;5105.770
2023-08-21;2023-08-19;5484627814;EAT BY SODEX/23-08-17;-99.000;5308.770
2023-08-08;2023-08-08;5484305369;MARIEHAMN   /23-08-06;-171.700;5407.770
2023-08-07;2023-08-07;5490990789;46720388884;776.000;5579.470
2023-08-07;2023-08-06;5484782784;MARIEHAMN   /23-08-04;-1379.210;4803.470
2023-08-07;2023-08-06;5484782741;MARIEHAMN   /23-08-04;-141.210;6182.680
2023-08-07;2023-08-06;5490990004;PETER HENELL;3000.000;6323.890
2023-08-01;2023-08-01;5484354451;SODER SPORTF/23-07-29;-2276.000;3323.890
2023-07-31;2023-07-31;5484877916;SL          /23-07-29;-78.000;5599.890
2023-07-31;2023-07-31;5484413669;KLANG MARKET/23-07-29;-184.000;5677.890
2023-07-31;2023-07-31;5484318110;HEMKOP MORBY/23-07-30;-355.210;5861.890
2023-07-31;2023-07-29;5490990004;PETER HENELL;3000.000;6217.100
2023-07-28;2023-07-28;5484321171;KLANG MARKET/23-07-26;-349.000;3217.100
2023-07-27;2023-07-27;5484670786;REIMERSHOLME/23-07-26;-193.000;3566.100
2023-07-27;2023-07-27;5484144323;ZETTLE  PANG/23-07-26;-138.000;3759.100
2023-07-27;2023-07-27;5484144307;ZETTLE  PANG/23-07-26;-198.000;3897.100
2023-07-26;2023-07-26;5490990004;PETER HENELL;3000.000;4095.100
2023-07-26;2023-07-26;5484103800;KATRINEHOLMS/23-07-25;-150.000;1095.100
2023-07-26;2023-07-26;5484386621;ICA NARA BER/23-07-25;-233.580;1245.100
2023-07-25;2023-07-25;5484633668;PIZZERIA NOB/23-07-24;-129.000;1478.680
2023-07-24;2023-07-24;5484755489;ICA SUPERMAR/23-07-23;-89.900;1607.680
2023-07-24;2023-07-23;5490990789;46768847083;-367.000;1697.580
2023-07-24;2023-07-23;5490990789;RAWFOODSHOP;-957.300;2064.580
2023-07-24;2023-07-22;5484087023;PIZZERIA NOB/23-07-21;-139.000;3021.880
2023-07-20;2023-07-20;5484646049;ICA SUPERMAR/23-07-19;-173.090;3160.880
2023-07-19;2023-07-19;5484244953;EKMAN & DAVI/23-07-18;-291.000;3333.970
2023-07-19;2023-07-19;5484798752;CIRCLE K KAT/23-07-18;-1015.880;3624.970
2023-07-17;2023-07-17;5484801109;MAXI ICA STO/23-07-16;-375.910;4640.850
2023-07-17;2023-07-15;5484666189;SIBYLLA FOLK/23-07-13;-114.000;5016.760
2023-07-17;2023-07-15;5484198975;ICA SUPERMAR/23-07-14;-37.900;5130.760
2023-07-13;2023-07-13;5484082814;PIZZERIA NOB/23-07-12;-129.000;5168.660
2023-07-13;2023-07-13;5490990789;46704984981;50.000;5297.660
2023-07-12;2023-07-12;5484420834;MAXI ICA STO/23-07-11;-392.380;5247.660
2023-07-12;2023-07-12;5490990004;PETER HENELL;3000.000;5640.040
2023-07-10;2023-07-10;5484840483;ICA SUPERMAR/23-07-09;-712.100;2640.040
2023-07-10;2023-07-08;5484492211;OOB KATRINEH/23-07-07;-257.000;3352.140
2023-07-10;2023-07-08;5484411217;APOTEKSGRUPP/23-07-07;-294.820;3609.140
2023-07-10;2023-07-08;5484397380;PIZZERIA RUN/23-07-07;-110.000;3903.960
2023-07-10;2023-07-08;5484171739;MAXI ICA STO/23-07-07;-849.470;4013.960
2023-07-07;2023-07-07;5484747621;SL          /23-07-05;-39.000;4863.430
2023-07-06;2023-07-06;5484413417;EAT BY SODEX/23-07-04;-99.000;4902.430
2023-07-05;2023-07-05;5484489338;COOP KONSUM /23-07-04;-85.000;5001.430
2023-07-03;2023-07-02;5490990789;46760450519;780.000;5086.430
2023-06-30;2023-06-30;5484170011;EDEN        /23-06-28;-465.000;4306.430
2023-06-29;2023-06-29;5484405364;THE DOORS   /23-06-27;-105.000;4771.430
2023-06-29;2023-06-29;5490990004;PETER HENELL;3000.000;4876.430
2023-06-27;2023-06-27;5484448114;SL          /23-06-25;-78.000;1876.430
2023-06-26;2023-06-26;5484185888;NATURKOMPANI/23-06-25;-449.000;1954.430
2023-06-26;2023-06-26;5484053328;ALEWALDS SPO/23-06-25;-708.000;2403.430
2023-06-26;2023-06-26;5484729177;STORA COOP A/23-06-25;-1239.830;3111.430
2023-06-26;2023-06-25;5484555312;SL          /23-06-23;-78.000;4351.260
2023-06-26;2023-06-25;5484011682;COOP KONSUM /23-06-24;-90.000;4429.260
2023-06-26;2023-06-25;5490990004;PETER HENELL;3000.000;4519.260
2023-06-26;2023-06-24;5484418076;P          H/23-06-23;-26.000;1519.260
2023-06-26;2023-06-24;5484390026;OLSTUGAN HOR/23-06-23;-168.000;1545.260
2023-06-26;2023-06-23;5484664685;SL          /23-06-21;-78.000;1713.260
2023-06-26;2023-06-23;5484051947;COOP KONSUM /23-06-22;-64.090;1791.260
2023-06-26;2023-06-23;5484051873;COOP KONSUM /23-06-22;-56.990;1855.350
2023-06-22;2023-06-22;5484372031;R           /23-06-21;-202.000;1912.340
2023-06-22;2023-06-22;5484766708;OOB SVEAVAGE/23-06-21;-72.000;2114.340
2023-06-22;2023-06-22;5484316617;SYSTRARNA P /23-06-21;-2340.000;2186.340
2023-06-22;2023-06-22;5490990789;1234557674;-110.000;4526.340
2023-06-21;2023-06-21;5490990789;46705438947;-100.000;4636.340
2023-06-21;2023-06-21;5484259243;4216125 7-E /23-06-21;-26.000;4736.340
2023-06-21;2023-06-21;5490990004;PETER HENELL;3000.000;4762.340
2023-06-20;2023-06-20;5484588936;COOP KONSUM /23-06-19;-221.960;1762.340
2023-06-16;2023-06-16;5484523675;SL          /23-06-14;-39.000;1984.300
2023-06-16;2023-06-16;5484323132;THE KITCHEN /23-06-15;-125.000;2023.300
2023-06-15;2023-06-15;5484671710;PIZZERIA RUN/23-06-14;-110.000;2148.300
2023-06-15;2023-06-15;5484497795;HEMKOP MORBY/23-06-14;-632.140;2258.300
2023-06-13;2023-06-13;5490990789;46705438947;-120.000;2890.440
2023-06-12;2023-06-10;5484466083;EAT BY SODEX/23-06-08;-99.000;3010.440
2023-06-12;2023-06-10;5484555475;ICA NARA BER/23-06-09;-313.980;3109.440
2023-06-07;2023-06-07;5484448526;ICA NARA BER/23-06-06;-166.900;3423.420
2023-06-07;2023-06-06;5484471527;PIZZERIA DAL/23-06-04;-117.000;3590.320
2023-06-05;2023-06-05;5484090241;ÄLVDALENS FI/23-06-04;-1050.000;3707.320
2023-06-05;2023-06-05;5490990789;46708338938;-600.000;4757.320
2023-06-05;2023-06-04;5484783973;ZETTLE  NYA /23-06-03;-160.000;5357.320
2023-06-05;2023-06-03;5484268852;RESTAURANG A/23-06-02;-110.000;5517.320
2023-06-05;2023-06-03;5484110357;OLSSON NILS /23-06-02;-64.000;5627.320
2023-06-05;2023-06-03;5484110356;OLSSON NILS /23-06-02;-483.000;5691.320
2023-06-05;2023-06-03;5484433247;ÄLVDALENS FI/23-06-02;-254.000;6174.320
2023-06-02;2023-06-02;5490990004;PETER HENELL;5000.000;6428.320
2023-05-30;2023-05-30;5484838602;CHUTNT      /23-05-29;-119.000;1428.320
2023-05-30;2023-05-30;5490990789;JULA SVERIGE;-367.900;1547.320
2023-05-29;2023-05-29;5490990789;AB STORSTOCK;-39.000;1915.220
2023-05-29;2023-05-29;5490990789;AB STORSTOCK;-39.000;1954.220
2023-05-29;2023-05-27;5484457396;COOP KONSUM /23-05-26;-111.320;1993.220
2023-05-25;2023-05-25;5484358428;SL          /23-05-23;-39.000;2104.540
2023-05-24;2023-05-24;5484860231;KUNGSBILJARD/23-05-23;-411.000;2143.540
2023-05-24;2023-05-24;5484860229;KUNGSBILJARD/23-05-23;-411.000;2554.540
2023-05-24;2023-05-24;5484860228;KUNGSBILJARD/23-05-23;-411.000;2965.540
2023-05-24;2023-05-24;5484860212;KUNGSBILJARD/23-05-23;-44.000;3376.540
2023-05-24;2023-05-24;5484496369;EAT BY SODEX/23-05-23;-22.000;3420.540
2023-05-23;2023-05-23;5490990004;PETER HENELL;2000.000;3442.540
2023-05-22;2023-05-22;5484566079;ICA NARA BER/23-05-21;-18.000;1442.540
2023-05-22;2023-05-21;5484230960;RESTAURANG S/23-05-20;-324.000;1460.540
2023-05-22;2023-05-21;5484753205;COOP KONSUM /23-05-20;-31.000;1784.540
2023-05-22;2023-05-20;5484741507;SL          /23-05-18;-78.000;1815.540
2023-05-22;2023-05-20;5484700398;RESTAURANG S/23-05-19;-298.000;1893.540
2023-05-22;2023-05-20;5484700386;RESTAURANG S/23-05-19;-115.000;2191.540
2023-05-22;2023-05-20;5484324334;COOP KONSUM /23-05-19;-31.000;2306.540
2023-05-22;2023-05-20;5484324314;COOP KONSUM /23-05-19;-15.000;2337.540
2023-05-19;2023-05-19;5484326044;ZETTLE  SYST/23-05-18;-76.000;2352.540
2023-05-19;2023-05-19;5484326041;ZETTLE  SYST/23-05-18;-37.000;2428.540
2023-05-19;2023-05-19;5484714259;COOP KONSUM /23-05-18;-149.990;2465.540
2023-05-19;2023-05-19;5484714183;COOP KONSUM /23-05-18;-20.000;2615.530
2023-05-15;2023-05-15;5484775361;SL          /23-05-13;-39.000;2635.530
2023-05-15;2023-05-15;5484079489;COOP KONSUM /23-05-14;-18.000;2674.530
2023-05-15;2023-05-14;5484220628;SYSTEMBOLAGE/23-05-13;-1197.800;2692.530
2023-05-15;2023-05-14;5484619859;HEMKOP MORBY/23-05-13;-239.950;3890.330
2023-05-15;2023-05-14;5484414270;COOP KONSUM /23-05-13;-83.900;4130.280
2023-05-15;2023-05-13;5490990004;PETER HENELL;3000.000;4214.180
2023-05-12;2023-05-12;5484787774;PIZZERIA RUN/23-05-11;-100.000;1214.180
2023-05-11;2023-05-11;5484793817;MAN IN THE M/23-05-10;-225.000;1314.180
2023-05-11;2023-05-11;5484793814;MAN IN THE M/23-05-10;-285.000;1539.180
2023-05-10;2023-05-10;5490990789;46705438947;-700.000;1824.180
2023-05-09;2023-05-09;5484416828;BRODERNAS VA/23-05-05;-150.000;2524.180
2023-05-08;2023-05-07;5484455212;COOP KONSUM /23-05-06;-54.950;2674.180
2023-05-04;2023-05-04;5484877451;APOTEKSGRUPP/23-05-03;-1645.920;2729.130
2023-05-04;2023-05-04;5484863774;RESTAURANG S/23-05-03;-324.000;4375.050
2023-05-03;2023-05-03;5484694370;COOP KONSUM /23-05-02;-132.750;4699.050
2023-05-03;2023-05-03;5490990004;PETER HENELL;3000.000;4831.800
2023-05-02;2023-05-02;5484795091;HEMKOP MORBY/23-05-01;-584.930;1831.800
2023-05-02;2023-05-02;5484638308;COOP KONSUM /23-05-01;-321.660;2416.730
2023-05-02;2023-04-30;5484313191;SL          /23-04-28;-39.000;2738.390
2023-05-02;2023-04-29;5484558748;EAT BY SODEX/23-04-27;-22.000;2777.390
2023-05-02;2023-04-29;5484558741;EAT BY SODEX/23-04-27;-99.000;2799.390
2023-04-27;2023-04-27;5484402730;EAT BY SODEX/23-04-25;-99.000;2898.390
2023-04-24;2023-04-24;5484322743;THE DUBLINER/23-04-21;-84.000;2997.390
2023-04-24;2023-04-23;5484785336;SL          /23-04-21;-39.000;3081.390
2023-04-21;2023-04-21;5490990789;46736227759;-300.000;3120.390
2023-04-21;2023-04-21;5484762973;SL          /23-04-19;-39.000;3420.390
2023-04-19;2023-04-19;5490990004;PETER HENELL;3000.000;3459.390
2023-04-18;2023-04-18;5484019177;OKQ8        /23-04-15;-916.870;459.390
2023-04-17;2023-04-17;5484745690;SL          /23-04-15;-39.000;1376.260
2023-04-17;2023-04-16;5484027904;RESTAURANG S/23-04-14;-403.000;1415.260
2023-04-17;2023-04-15;5490990789;46704841061;-180.000;1818.260
2023-04-17;2023-04-15;5484320956;EAT BY SODEX/23-04-13;-99.000;1998.260
2023-04-17;2023-04-15;5490990789;46736227759;-500.000;2097.260
2023-04-13;2023-04-13;5484257366;EAT BY SODEX/23-04-11;-99.000;2597.260
2023-04-12;2023-04-12;5484683430;KUNGSBILJARD/23-04-11;-178.000;2696.260
2023-04-12;2023-04-12;5484683427;KUNGSBILJARD/23-04-11;-264.000;2874.260
2023-04-12;2023-04-12;5484683426;KUNGSBILJARD/23-04-11;-195.000;3138.260
2023-04-11;2023-04-07;5490990789;46707606473;183.150;3333.260
2023-04-11;2023-04-07;5490990789;46707591203;160.000;3150.110
2023-04-11;2023-04-07;5490990789;46723227253;155.000;2990.110
2023-04-11;2023-04-07;5490990789;FOODORA AB;-633.000;2835.110
2023-04-06;2023-04-06;5484531097;COOP KONSUM /23-04-05;-240.980;3468.110
2023-04-05;2023-04-05;5484590510;KMARKT CENTR/23-04-04;-130.000;3709.090
2023-04-03;2023-04-02;5484437377;COOP KONSUM /23-04-01;-188.850;3839.090
2023-03-30;2023-03-30;5484656444;COOP KONSUM /23-03-29;-174.520;4027.940
2023-03-30;2023-03-30;5490990004;PETER HENELL;3000.000;4202.460
2023-03-28;2023-03-28;5484822546;COOP KONSUM /23-03-27;-106.210;1202.460
2023-03-27;2023-03-25;5484582611;RESTAURANG S/23-03-24;-298.000;1308.670
2023-03-23;2023-03-23;5484093598;SYSTEMBOLAGE/23-03-22;-876.000;1606.670
2023-03-20;2023-03-20;5484047834;COOP KONSUM /23-03-19;-189.790;2482.670
2023-03-20;2023-03-18;5484723355;RESTAURANG S/23-03-17;-482.000;2672.460
2023-03-20;2023-03-18;5484347201;COOP KONSUM /23-03-17;-170.980;3154.460
2023-03-16;2023-03-16;5484147080;OLEARYS MOS /23-03-14;-356.000;3325.440
2023-03-16;2023-03-16;5484147051;OLEARYS MOS /23-03-14;-178.000;3681.440
2023-03-16;2023-03-16;5484040712;EAT BY SODEX/23-03-14;-99.000;3859.440
2023-03-13;2023-03-11;5484055216;SL          /23-03-09;-39.000;3958.440
2023-03-13;2023-03-11;5484652233;EAT BY SODEX/23-03-09;-22.000;3997.440
2023-03-13;2023-03-11;5484652212;EAT BY SODEX/23-03-09;-99.000;4019.440
2023-03-13;2023-03-11;5484212711;RESTAURANG S/23-03-10;-403.000;4118.440
2023-03-08;2023-03-08;5484569885;COOP KONSUM /23-03-07;-408.650;4521.440
2023-03-06;2023-03-04;5484740852;RESTAURANG S/23-03-03;-219.000;4930.090
2023-03-03;2023-03-03;5484617137;SL          /23-03-01;-39.000;5149.090
2023-03-03;2023-03-03;5484420836;THE DOORS   /23-03-01;-99.000;5188.090
2023-03-03;2023-03-03;5490990789;46720388884;-4495.000;5287.090
2023-03-03;2023-03-03;5490990004;PETER HENELL;4000.000;9782.090
2023-03-02;2023-03-02;5484157487;TAXI STOCKHO/23-03-01;-90.000;5782.090
2023-03-01;2023-03-01;5490990789;46721428359;600.000;5872.090
2023-03-01;2023-03-01;5484549207;COOP KONSUM /23-02-28;-148.750;5272.090
2023-03-01;2023-03-01;5490990789;46721428359;475.000;5420.840
2023-02-28;2023-02-28;5484331145;COOP KONSUM /23-02-27;-240.220;4945.840
2023-02-27;2023-02-27;5484504373;SL          /23-02-25;-39.000;5186.060
2023-02-27;2023-02-26;5484596292;LAGAMATI    /23-02-25;-1690.000;5225.060
2023-02-27;2023-02-25;5484841928;RESTAURANG S/23-02-24;-561.000;6915.060
2023-02-27;2023-02-25;5484433713;COOP KONSUM /23-02-24;-53.900;7476.060
2023-02-27;2023-02-25;5490990004;PETER HENELL;5000.000;7529.960
2023-02-23;2023-02-23;5484029224;GRANIT 40413/23-02-22;-419.000;2529.960
2023-02-23;2023-02-23;5484520365;1101 CERVERA/23-02-22;-369.000;2948.960
2023-02-22;2023-02-22;5490990789;IKEA SVENSKA;-948.000;3317.960
2023-02-21;2023-02-21;5484699065;RESTAURANG S/23-02-19;-298.000;4265.960
2023-02-20;2023-02-18;5484276160;EAT BY SODEX/23-02-16;-22.000;4563.960
2023-02-20;2023-02-18;5484276125;EAT BY SODEX/23-02-16;-99.000;4585.960
2023-02-20;2023-02-18;5484046921;RESTAURANG S/23-02-17;-482.000;4684.960
2023-02-20;2023-02-18;5484558022;COOP KONSUM /23-02-17;-92.270;5166.960
2023-02-17;2023-02-17;5484478159;SL          /23-02-15;-78.000;5259.230
2023-02-17;2023-02-17;5484237135;THE DUBLINER/23-02-15;-262.000;5337.230
2023-02-17;2023-02-17;5484237130;THE DUBLINER/23-02-15;-84.000;5599.230
2023-02-17;2023-02-17;5484744044;ICA NARA BER/23-02-16;-117.050;5683.230
2023-02-15;2023-02-15;5490990789;46702984673;350.000;5800.280
2023-02-15;2023-02-15;5490990789;46720388884;350.000;5450.280
2023-02-13;2023-02-12;5484077883;COOP KONSUM /23-02-11;-90.400;5100.280
2023-02-13;2023-02-11;5484088147;RESTAURANG S/23-02-10;-423.000;5190.680
2023-02-09;2023-02-09;5484464164;LA GAZELLE H/23-02-08;-145.000;5613.680
2023-02-09;2023-02-09;5484059610;COOP KONSUM /23-02-08;-80.400;5758.680
2023-02-07;2023-02-07;5490990789;46705979742;750.000;5839.080
2023-02-06;2023-02-05;5484135637;THE DOORS   /23-02-03;-98.000;5089.080
2023-02-06;2023-02-05;5484135562;THE CHURCHIL/23-02-03;-196.000;5187.080
2023-02-06;2023-02-04;5484304775;RESTAURANG S/23-02-02;-115.000;5383.080
2023-02-06;2023-02-04;5490990789;46721428359;900.000;5498.080
2023-02-06;2023-02-04;5490990789;46705438947;880.000;4598.080
2023-02-01;2023-02-01;5484085623;COOP KONSUM /23-01-31;-256.320;3718.080
2023-01-31;2023-01-31;5490990004;56903307478 ;-7000.000;3974.400
2023-01-30;2023-01-29;5484721578;COOP KONSUM /23-01-28;-235.340;10974.400
2023-01-30;2023-01-28;5484343757;RESTAURANG S/23-01-27;-403.000;11209.740
2023-01-27;2023-01-27;5490990004;PETER HENELL;10000.000;11612.740
2023-01-26;2023-01-26;5484517761;PARS CAFE   /23-01-25;-216.000;1612.740
2023-01-25;2023-01-25;5484747316;INSPICE     /23-01-24;-119.000;1828.740
2023-01-25;2023-01-25;5484584710;ENARXEIS AB /23-01-24;-96.000;1947.740
2023-01-25;2023-01-25;5484497542;KALASKAFFE I/23-01-24;-40.000;2043.740
2023-01-25;2023-01-25;5484095744;COOP KONSUM /23-01-24;-118.850;2083.740
2023-01-25;2023-01-25;5484654539;THE TOWNHOUS/23-01-24;-581.900;2202.590
2023-01-25;2023-01-25;5490990789;46702622386;100.000;2784.490
2023-01-23;2023-01-21;5484606319;RESTAURANG S/23-01-20;-403.000;2684.490
2023-01-20;2023-01-20;5490990004;PETER HENELL;2000.000;3087.490
2023-01-19;2023-01-19;5484624434;COOP KONSUM /23-01-18;-45.450;1087.490
2023-01-18;2023-01-18;5484867447;COOP KONSUM /23-01-17;-229.390;1132.940
2023-01-16;2023-01-15;5484491369;COOP KONSUM /23-01-14;-63.900;1362.330
2023-01-16;2023-01-14;5484411661;EAT BY SODEX/23-01-12;-99.000;1426.230
2023-01-12;2023-01-12;5484564736;RESTAURANG S/23-01-11;-115.000;1525.230
2023-01-12;2023-01-12;5484278499;COOP KONSUM /23-01-11;-30.950;1640.230
2023-01-12;2023-01-12;5490990789;APOTEKET AB;-609.500;1671.180
2023-01-09;2023-01-09;5484402211;COOP KONSUM /23-01-08;-76.740;2280.680
2023-01-09;2023-01-07;5484866962;RESTAURANG S/23-01-06;-353.000;2357.420
2023-01-09;2023-01-06;5484072823;COOP KONSUM /23-01-05;-39.500;2710.420
2023-01-02;2023-01-02;5484646911;PIZZERIA RUN/23-01-01;-130.000;2749.920
2023-01-02;2023-01-02;5490990004;PETER HENELL;2000.000;2879.920
2023-01-02;2023-01-01;5484465007;HEMKOP MORBY/22-12-31;-479.280;879.920
2023-01-02;2022-12-31;5484715076;APOTEKSGRUPP/22-12-30;-137.890;1359.200
2023-01-02;2022-12-31;5484056324;SYSTEMBOLAGE/22-12-31;-893.200;1497.090
2023-01-02;2022-12-31;5490990789;AB STORSTOCK;-39.000;2390.290
2022-12-30;2022-12-30;5484113050;7ELEVEN ODEN/22-12-30;-21.000;2429.290
2022-12-30;2022-12-30;5490990789;AB STORSTOCK;-39.000;2450.290
2022-12-30;2022-12-30;5490990789;AB STORSTOCK;-39.000;2489.290
2022-12-29;2022-12-29;5484137820;PIZZERIA RUN/22-12-28;-120.000;2528.290
2022-12-28;2022-12-28;5484203941;OKQ8        /22-12-24;-740.140;2648.290
2022-12-27;2022-12-24;5490990004;PETER HENELL;2000.000;3388.430
2022-12-22;2022-12-22;5484065564;PANDURO HOBB/22-12-21;-234.200;1388.430
2022-12-22;2022-12-22;5484868928;OSTERQVIST D/22-12-21;-374.000;1622.630
2022-12-22;2022-12-22;5484865385;FISKELEGET I/22-12-21;-360.000;1996.630
2022-12-22;2022-12-22;5484725615;RESTAURANG S/22-12-21;-250.000;2356.630
2022-12-22;2022-12-22;5484344026;COOP KONSUM /22-12-21;-65.110;2606.630
2022-12-21;2022-12-21;5484583982;ICA NARA BER/22-12-20;-107.860;2671.740
2022-12-21;2022-12-21;5490990789;AB STORSTOCK;-39.000;2779.600
2022-12-19;2022-12-16;5490990789;AB STORSTOCK;-39.000;2818.600
2022-12-16;2022-12-16;5490990789;AB STORSTOCK;-39.000;2857.600
2022-12-16;2022-12-16;5490990789;AB STORSTOCK;-39.000;2896.600
2022-12-14;2022-12-14;5484566544;STUREHOF    /22-12-12;-116.000;2935.600
2022-12-12;2022-12-12;5490990789;AB STORSTOCK;-39.000;3051.600
2022-12-12;2022-12-10;5484739991;RESTAURANG S/22-12-09;-199.000;3090.600
2022-12-09;2022-12-09;5490990004;PETER HENELL;2000.000;3289.600
2022-12-06;2022-12-06;5490990789;AB STORSTOCK;-39.000;1289.600
2022-12-06;2022-12-06;5484370767;ICA NARA BER/22-12-05;-40.500;1328.600
2022-12-06;2022-12-06;5490990789;AB STORSTOCK;-39.000;1369.100
2022-12-05;2022-12-05;5484705554;ICA NARA BER/22-12-04;-190.930;1408.100
2022-12-05;2022-12-05;5484329647;WEBHALLEN   /22-12-04;-499.000;1599.030
2022-12-05;2022-12-04;5484270583;ALEWALDS SPO/22-12-03;-499.000;2098.030
2022-12-05;2022-12-04;5484344047;THE DOORS   /22-12-02;-98.000;2597.030
2022-12-05;2022-12-04;5484300355;LA GAZELLE H/22-12-03;-135.000;2695.030
2022-12-05;2022-12-04;5490990789;AB STORSTOCK;-39.000;2830.030
2022-12-05;2022-12-03;5490990789;AB STORSTOCK;-39.000;2869.030
2022-12-05;2022-12-03;5490990789;AB STORSTOCK;-39.000;2908.030
2022-12-02;2022-12-02;5490990789;AB STORSTOCK;-39.000;2947.030
2022-12-02;2022-12-02;5490990789;AB STORSTOCK;-39.000;2986.030
2022-12-01;2022-12-01;5484025356;APOTEKSGRUPP/22-11-30;-211.870;3025.030
2022-11-30;2022-11-30;5484532427;ICA NARA BER/22-11-29;-218.830;3236.900
2022-11-29;2022-11-29;5484448566;CAPABILITY G/22-11-28;-30.970;3455.730
2022-11-28;2022-11-27;5484267151;LEIRIA      /22-11-26;-60.180;3486.700
2022-11-28;2022-11-26;5490990789;46766344976;-500.000;3546.880
2022-11-28;2022-11-26;5490990004;PETER HENELL;3000.000;4046.880
2022-11-25;2022-11-25;5490990789;46761846680;-200.000;1046.880
2022-11-24;2022-11-24;5490990789;46707591203;-220.000;1246.880
2022-11-24;2022-11-24;5484524428;LEIRIA      /22-11-23;-119.830;1466.880
2022-11-24;2022-11-24;5484524427;LEIRIA      /22-11-23;-161.700;1586.710
2022-11-24;2022-11-24;5490990789;46707591203;-280.000;1748.410
2022-11-23;2022-11-23;5490990789;46761846680;-320.000;2028.410
2022-11-22;2022-11-22;5490990789;46761846680;-400.000;2348.410
2022-11-22;2022-11-22;5484848251;LEIRIA      /22-11-21;-182.880;2748.410
2022-11-22;2022-11-22;5484761512;ENPT1219    /22-11-20;-1501.440;2931.290
2022-11-22;2022-11-22;5490990789;46707591203;-140.000;4432.730
2022-11-21;2022-11-21;5490990789;1236693089;-150.000;4572.730
2022-11-21;2022-11-21;5484358955;TASTE ARLAND/22-11-20;-398.000;4722.730
2022-11-21;2022-11-21;5490990789;46707591203;-200.000;5120.730
2022-11-21;2022-11-19;5484264471;RESTAURANG S/22-11-18;-115.000;5320.730
2022-11-18;2022-11-18;5484739226;PIZZERIA MAE/22-11-16;-115.000;5435.730
2022-11-18;2022-11-18;5484374119;ICA NARA BER/22-11-17;-237.970;5550.730
2022-11-17;2022-11-17;5484531303;STADIUM DROT/22-11-16;-504.000;5788.700
2022-11-16;2022-11-16;5490990789;AB STORSTOCK;-39.000;6292.700
2022-11-16;2022-11-16;5490990789;AB STORSTOCK;-39.000;6331.700
2022-11-14;2022-11-13;5484857796;RESTAURANG S/22-11-12;-199.000;6370.700
2022-11-14;2022-11-12;5484611572;HAWAII POKE /22-11-11;-135.000;6569.700
2022-11-11;2022-11-11;5484704094;PIZZERIA RUN/22-11-10;-110.000;6704.700
2022-11-11;2022-11-11;5484762448;SYSTEMBOLAGE/22-11-11;-716.000;6814.700
2022-11-11;2022-11-11;5490990789;AB STORSTOCK;-39.000;7530.700
2022-11-10;2022-11-10;5484871710;EAT BY SODEX/22-11-08;-94.000;7569.700
2022-11-10;2022-11-10;5484382655;ICA NARA BER/22-11-09;-198.450;7663.700
2022-11-08;2022-11-08;5490990789;AB STORSTOCK;-39.000;7862.150
2022-11-08;2022-11-08;5490990789;AB STORSTOCK;-39.000;7901.150
2022-11-07;2022-11-06;5484809117;RESTAURANG S/22-11-05;-315.000;7940.150
2022-11-07;2022-11-06;5490990789;46707591203;-250.000;8255.150
2022-11-07;2022-11-05;5484805577;RESTAURANG S/22-11-04;-205.000;8505.150
2022-11-03;2022-11-03;5484526177;APOTEKSGRUPP/22-11-02;-134.580;8710.150
2022-11-03;2022-11-03;5484193408;COOP KONSUM /22-11-02;-248.160;8844.730
2022-10-31;2022-10-30;5484249351;BERGSHAMRA B/22-10-29;-255.000;9092.890
2022-10-31;2022-10-29;5484540488;EAT BY SODEX/22-10-27;-94.000;9347.890
2022-10-31;2022-10-29;5484092060;RESTAURANG S/22-10-28;-415.000;9441.890
2022-10-28;2022-10-28;5484277467;STRINGFELLOW/22-10-27;-152.000;9856.890
2022-10-27;2022-10-27;5484268976;EAT BY SODEX/22-10-25;-22.000;10008.890
2022-10-27;2022-10-27;5484268944;EAT BY SODEX/22-10-25;-94.000;10030.890
2022-10-27;2022-10-27;5484524744;COOP KONSUM /22-10-26;-35.880;10124.890
2022-10-27;2022-10-27;5490990789;AB STORSTOCK;-39.000;10160.770
2022-10-27;2022-10-27;5490990789;AB STORSTOCK;-39.000;10199.770
2022-10-25;2022-10-25;5490990789;AB STORSTOCK;-39.000;10238.770
2022-10-24;2022-10-24;5490990789;46736627274;750.000;10277.770
2022-10-24;2022-10-24;5490990789;46721428359;750.000;9527.770
2022-10-24;2022-10-24;5490990789;46705979742;750.000;8777.770
2022-10-24;2022-10-23;5484060573;THE DOORS   /22-10-21;-274.000;8027.770
2022-10-24;2022-10-23;5484060552;THE DOORS   /22-10-21;-98.000;8301.770
2022-10-24;2022-10-22;5484385853;EAT BY SODEX/22-10-20;-94.000;8399.770
2022-10-24;2022-10-22;5484496943;MAN IN THE M/22-10-21;-348.000;8493.770
2022-10-20;2022-10-20;5484231135;EAT BY SODEX/22-10-18;-28.000;8841.770
2022-10-20;2022-10-20;5484231112;EAT BY SODEX/22-10-18;-94.000;8869.770
2022-10-20;2022-10-20;5490990789;AB STORSTOCK;-39.000;8963.770
2022-10-18;2022-10-18;5490990789;AB STORSTOCK;-39.000;9002.770
2022-10-17;2022-10-15;5490990789;46707591203;6450.000;9041.770
2022-10-14;2022-10-14;5484033208;ICA NARA BER/22-10-13;-127.200;2591.770
2022-10-13;2022-10-13;5484228900;SYSTEMBOLAGE/22-10-13;-846.600;2718.970
2022-10-13;2022-10-13;5490990789;AB STORSTOCK;-39.000;3565.570
2022-10-12;2022-10-12;5484741749;EAT BY SODEX/22-10-10;-94.000;3604.570
2022-10-10;2022-10-10;5490990004;PETER HENELL;2000.000;3698.570
2022-10-10;2022-10-10;5490990789;AB STORSTOCK;-39.000;1698.570
2022-10-10;2022-10-09;5484545881;RESTAURANG S/22-10-08;-250.000;1737.570
2022-10-10;2022-10-08;5484087964;RESTAURANG S/22-10-07;-115.000;1987.570
2022-10-07;2022-10-07;5484552648;PIZZERIA RUN/22-10-06;-110.000;2102.570
2022-10-06;2022-10-06;5484605481;EAT BY SODEX/22-10-04;-94.000;2212.570
2022-10-04;2022-10-04;5490990789;AB STORSTOCK;-39.000;2306.570
2022-09-29;2022-09-29;5484015233;PIZZERIA GRA/22-09-28;-188.000;2345.570
2022-09-29;2022-09-29;5484717413;4250149 PRES/22-09-29;-31.000;2533.570
2022-09-28;2022-09-28;5484162617;TASTE ARLAND/22-09-27;-74.000;2564.570
2022-09-28;2022-09-28;5484266997;OLSTUGAN TUL/22-09-27;-176.000;2638.570
2022-09-28;2022-09-28;5484266995;OLSTUGAN TUL/22-09-27;-184.800;2814.570
2022-09-26;2022-09-25;5484084146;THE DOORS   /22-09-23;-96.000;2999.370
2022-09-26;2022-09-25;5484794553;RESTAURANG S/22-09-24;-355.000;3095.370
2022-09-26;2022-09-25;5484427446;COOP KONSUM /22-09-24;-30.890;3450.370
2022-09-26;2022-09-25;5490990789;46707606473;-280.000;3481.260
2022-09-26;2022-09-24;5490990789;AB STORSTOCK;-39.000;3761.260
2022-09-26;2022-09-24;5490990789;AB STORSTOCK;-39.000;3800.260
2022-09-22;2022-09-22;5484542919;EAT BY SODEX/22-09-20;-94.000;3839.260
2022-09-20;2022-09-20;5490990789;AB STORSTOCK;-39.000;3933.260
2022-09-19;2022-09-19;5490990004;PETER HENELL;3000.000;3972.260
2022-09-19;2022-09-18;5484600077;OOB ARNINGE /22-09-16;-218.000;972.260
2022-09-19;2022-09-17;5484632841;STORA COOP A/22-09-16;-353.990;1190.260
2022-09-16;2022-09-16;5484261424;SYSTEMBOLAGE/22-09-16;-700.400;1544.250
2022-09-12;2022-09-11;5484562117;COOP KONSUM /22-09-10;-64.450;2244.650
2022-09-12;2022-09-10;5490990789;JIGHEAD AB;-250.000;2309.100
2022-09-08;2022-09-08;5484124709;ICA NARA BER/22-09-07;-192.970;2559.100
2022-09-08;2022-09-08;5490990789;AB STORSTOCK;-39.000;2752.070
2022-09-07;2022-09-07;5484758506;OLEARYS MOS /22-09-05;-178.000;2791.070
2022-09-07;2022-09-07;5484758501;OLEARYS MOS /22-09-05;-178.000;2969.070
2022-09-06;2022-09-06;5484278530;WORLD FUSION/22-09-05;-58.000;3147.070
2022-09-06;2022-09-06;5484278529;WORLD FUSION/22-09-05;-179.000;3205.070
2022-09-05;2022-09-05;5490990789;AB STORSTOCK;-39.000;3384.070
2022-09-05;2022-09-04;5484368210;COOP KONSUM /22-09-03;-62.900;3423.070
2022-09-05;2022-09-03;5484873783;BELLISIMO   /22-09-02;-105.000;3485.970
2022-09-02;2022-09-02;5484469327;OLEARYS MOS /22-08-31;-89.000;3590.970
2022-09-02;2022-09-02;5490990004;PETER HENELL;3000.000;3679.970
2022-09-01;2022-09-01;5484079550;BELLISIMO   /22-08-31;-75.000;679.970
2022-09-01;2022-09-01;5484514743;EAT BY SODEX/22-08-30;-94.000;754.970
2022-08-31;2022-08-31;5484593074;COOP KONSUM /22-08-30;-193.430;848.970
2022-08-31;2022-08-31;5490990789;AB STORSTOCK;-39.000;1042.400
2022-08-31;2022-08-31;5490990789;AB STORSTOCK;-39.000;1081.400
2022-08-30;2022-08-30;5490990789;AB STORSTOCK;-39.000;1120.400
2022-08-30;2022-08-30;5490990789;AB STORSTOCK;-39.000;1159.400
2022-08-29;2022-08-29;5484714813;HOTEL AT SIX/22-08-27;-178.000;1198.400
2022-08-29;2022-08-29;5484714787;HOTEL AT SIX/22-08-27;-178.000;1376.400
2022-08-29;2022-08-29;5484714748;HOTEL AT SIX/22-08-27;-178.000;1554.400
2022-08-29;2022-08-28;5484061302;PYTTIRIAN   /22-08-27;-160.000;1732.400
2022-08-29;2022-08-28;5484044577;ANKARA KEBAB/22-08-27;-60.000;1892.400
2022-08-29;2022-08-27;5490990789;AB STORSTOCK;-39.000;1952.400
2022-08-29;2022-08-27;5490990789;AB STORSTOCK;-39.000;1991.400
2022-08-26;2022-08-26;5484532365;OKQ8        /22-08-25;-317.280;2030.400
2022-08-26;2022-08-26;5490990789;46701609908;105.000;2347.680
2022-08-26;2022-08-26;5490990789;46702622386;105.000;2242.680
2022-08-25;2022-08-25;5484440630;M/S ECKERO  /22-08-24;-1154.000;2137.680
2022-08-25;2022-08-25;5484440615;M/S ECKERO  /22-08-24;-350.000;3291.680
2022-08-25;2022-08-25;5490990789;46738674668;-280.000;3641.680
2022-08-23;2022-08-23;5484865155;OKQ8        /22-08-22;-605.410;3921.680
2022-08-23;2022-08-23;5484838337;OKQ8        /22-08-22;-29.000;4527.090
2022-08-23;2022-08-23;5484477182;M/S ROSELLA /22-08-22;-762.000;4556.090
2022-08-23;2022-08-23;5484477180;M/S ROSELLA /22-08-22;-25.000;5318.090
2022-08-23;2022-08-23;5484477179;M/S ROSELLA /22-08-22;-50.000;5343.090
2022-08-23;2022-08-23;5484477176;M/S ROSELLA /22-08-22;-108.000;5393.090
2022-08-22;2022-08-22;5484334366;BELLISIMO   /22-08-21;-120.000;5501.090
2022-08-22;2022-08-22;5490990004;PETER HENELL;4000.000;5621.090
2022-08-22;2022-08-21;5484825102;THE DOORS   /22-08-19;-96.000;1621.090
2022-08-22;2022-08-20;5484875966;EAT BY SODEX/22-08-18;-94.000;1717.090
2022-08-22;2022-08-20;5484455013;LOOPEN MARIN/22-08-19;-550.000;1811.090
2022-08-22;2022-08-20;5484860826;ICA NARA BER/22-08-19;-28.000;2361.090
2022-08-22;2022-08-20;5490990789;AB STORSTOCK;-39.000;2389.090
2022-08-22;2022-08-20;5490990789;46705438947;-180.000;2428.090
2022-08-19;2022-08-19;5490990789;AB STORSTOCK;-39.000;2608.090
2022-08-18;2022-08-18;5484502538;THE BISHOP  /22-08-17;-78.000;2647.090
2022-08-18;2022-08-18;5484490427;KUNGSBILJARD/22-08-17;-138.000;2725.090
2022-08-18;2022-08-18;5484490425;KUNGSBILJARD/22-08-17;-172.000;2863.090
2022-08-18;2022-08-18;5490990789;AB STORSTOCK;-39.000;3035.090
2022-08-18;2022-08-18;5490990789;AB STORSTOCK;-39.000;3074.090
2022-08-17;2022-08-17;5490990789;AB STORSTOCK;-39.000;3113.090
2022-08-16;2022-08-16;5484656267;ANKARA KEBAB/22-08-15;-70.000;3152.090
2022-08-15;2022-08-15;5484106553;GRANIT 40413/22-08-15;-337.000;3222.090
2022-08-15;2022-08-15;5490990789;AB STORSTOCK;-39.000;3559.090
2022-08-15;2022-08-15;5490990004;PETER HENELL;2000.000;3598.090
2022-08-15;2022-08-14;5484738839;GRANIT 40413/22-08-13;-240.000;1598.090
2022-08-15;2022-08-14;5484720709;AHLENS CITY /22-08-13;-158.000;1838.090
2022-08-15;2022-08-14;5484642235;COOP KONSUM /22-08-12;-26.500;1996.090
2022-08-15;2022-08-14;5484859838;COOP KONSUM /22-08-13;-22.000;2022.590
2022-08-15;2022-08-14;5484348491;ASIAN MARKET/22-08-13;-570.500;2044.590
2022-08-15;2022-08-13;5484782387;APOTEKSGRUPP/22-08-12;-197.890;2615.090
2022-08-15;2022-08-13;5484765114;RESTAURANG S/22-08-12;-373.000;2812.980
2022-08-15;2022-08-13;5490990789;AB STORSTOCK;-39.000;3185.980
2022-08-15;2022-08-13;5490990789;AB STORSTOCK;-39.000;3224.980
2022-08-12;2022-08-12;5484870694;BAR BURGER C/22-08-11;-119.000;3263.980
2022-08-11;2022-08-11;5490990789;AB STORSTOCK;-39.000;3382.980
2022-08-11;2022-08-11;5490990789;AB STORSTOCK;-39.000;3421.980
2022-08-10;2022-08-10;5484763949;COOP KONSUM /22-08-09;-32.950;3460.980
2022-08-08;2022-08-08;5484430593;BELLISIMO   /22-08-07;-105.000;3493.930
2022-08-08;2022-08-06;5484214144;GUNNAR OLSSO/22-08-05;-129.000;3598.930
2022-08-08;2022-08-06;5484440880;PANDA SUSHI /22-08-05;-140.000;3727.930
2022-08-08;2022-08-06;5484086461;COOP KONSUM /22-08-05;-192.230;3867.930
2022-08-05;2022-08-05;5490990789;AB STORSTOCK;-39.000;4060.160
2022-08-05;2022-08-05;5490990789;AB STORSTOCK;-39.000;4099.160
2022-08-03;2022-08-03;5484516358;BELLISIMO   /22-08-02;-75.000;4138.160
2022-08-03;2022-08-03;5490990789;1234832028;-70.000;4213.160
2022-08-02;2022-08-02;5484179928;SYSTEMBOLAGE/22-08-01;-1060.200;4283.160
2022-08-01;2022-08-01;5490990789;AB STORSTOCK;-39.000;5343.360
2022-07-29;2022-07-29;5484522468;COOP KONSUM /22-07-28;-245.740;5382.360
2022-07-29;2022-07-29;5490990789;46768847083;888.000;5628.100
2022-07-27;2022-07-27;5484066034;PIZZERIA NOB/22-07-26;-120.000;4740.100
2022-07-26;2022-07-26;5484670982;PIZZERIA NOB/22-07-25;-89.000;4860.100
2022-07-26;2022-07-26;5490990789;46704984981;50.000;4949.100
2022-07-25;2022-07-25;5490990004;PETER HENELL;3000.000;4899.100
2022-07-22;2022-07-22;5484639875;MAXI ICA STO/22-07-20;-266.950;1899.100
2022-07-22;2022-07-22;5490990789;46768847083;-130.000;2166.050
2022-07-19;2022-07-19;5484395143;QSTAR KATRIN/22-07-17;-317.620;2296.050
2022-07-19;2022-07-19;5484584141;MATPIRATEN K/22-07-18;-258.540;2613.670
2022-07-18;2022-07-17;5484226112;ICA SUPERMAR/22-07-16;-242.250;2872.210
2022-07-18;2022-07-17;5490990789;1232664761;-30.000;3114.460
2022-07-13;2022-07-13;5484231204;PIZZERIA NOB/22-07-12;-89.000;3144.460
2022-07-13;2022-07-13;5484014427;MAXI ICA STO/22-07-11;-243.360;3233.460
2022-07-12;2022-07-12;5484374034;INTERSPORT K/22-07-11;-398.000;3476.820
2022-07-11;2022-07-11;5484534480;SVE DISCSPOR/22-07-10;-1850.000;3874.820
2022-07-11;2022-07-10;5484251284;PIZZERIA NOB/22-07-09;-89.000;5724.820
2022-07-11;2022-07-09;5484848265;ICA SUPERMAR/22-07-08;-75.580;5813.820
2022-07-08;2022-07-08;5484440498;MAXI ICA STO/22-07-06;-754.020;5889.400
2022-07-06;2022-07-06;5484405215;PIZZERIA NOB/22-07-05;-109.000;6643.420
2022-07-05;2022-07-05;5484781204;BELLISIMO   /22-07-04;-135.000;6752.420
2022-07-05;2022-07-05;5490990004;PETER HENELL;5000.000;6887.420
2022-07-04;2022-07-02;5484759709;OKQ8        /22-07-01;-728.140;1887.420
2022-07-04;2022-07-02;5484759707;OKQ8        /22-07-01;-36.500;2615.560
2022-07-04;2022-07-02;5484509464;ICA NARA BER/22-07-01;-16.900;2652.060
2022-06-30;2022-06-30;5484216251;HEMKÖP MÖRBY/22-06-29;-588.130;2668.960
2022-06-29;2022-06-29;5484362652;COOP KONSUM /22-06-27;-221.800;3257.090
2022-06-29;2022-06-29;5484393628;ICA NARA BER/22-06-28;-14.900;3478.890
2022-06-29;2022-06-29;5490990004;PETER HENELL;2000.000;3493.790
2022-06-29;2022-06-29;5490990789;AB STORSTOCK;-39.000;1493.790
2022-06-28;2022-06-28;5484564052;APOTEKSGRUPP/22-06-27;-291.490;1532.790
2022-06-27;2022-06-25;5484739126;COOP KONSUM /22-06-23;-37.500;1824.280
2022-06-27;2022-06-24;5484194130;RESTAURANG S/22-06-23;-190.000;1861.780
2022-06-23;2022-06-23;5484588480;COOP KONSUM /22-06-22;-35.950;2051.780
2022-06-22;2022-06-22;5484622087;BELLISIMO   /22-06-21;-110.000;2087.730
2022-06-20;2022-06-19;5484782039;EAT BY SODEX/22-06-17;-94.000;2197.730
2022-06-20;2022-06-18;5484523945;EAT BY SODEX/22-06-16;-94.000;2291.730
2022-06-17;2022-06-17;5490990789;AB STORSTOCK;-39.000;2385.730
2022-06-17;2022-06-17;5490990789;AB STORSTOCK;-39.000;2424.730
2022-06-16;2022-06-16;5484117306;RESTAURANG S/22-06-15;-109.000;2463.730
2022-06-16;2022-06-16;5490990789;AB STORSTOCK;-39.000;2572.730
2022-06-16;2022-06-16;5490990789;AB STORSTOCK;-39.000;2611.730
2022-06-15;2022-06-15;5484044296;BELLISIMO   /22-06-14;-110.000;2650.730
2022-06-14;2022-06-14;5484788992;RESTAURANG S/22-06-13;-109.000;2760.730
2022-06-13;2022-06-13;5484710111;COOP KONSUM /22-06-12;-17.430;2869.730
2022-06-13;2022-06-12;5484639313;COOP KONSUM /22-06-10;-85.090;2887.160
2022-06-13;2022-06-12;5484528243;CAFE EKORREN/22-06-11;-264.000;2972.250
2022-06-13;2022-06-11;5484431150;EAT BY SODEX/22-06-09;-94.000;3236.250
2022-06-13;2022-06-11;5484058794;RESTAURANG S/22-06-10;-109.000;3330.250
2022-06-13;2022-06-11;5484741191;HEMKÖP MÖRBY/22-06-10;-365.710;3439.250
2022-06-13;2022-06-11;5490990789;AB STORSTOCK;-39.000;3804.960
2022-06-13;2022-06-11;5490990789;AB STORSTOCK;-39.000;3843.960
2022-06-13;2022-06-11;5490990789;AB STORSTOCK;-39.000;3882.960
2022-06-10;2022-06-10;5484141706;SYSTEMBOLAGE/22-06-10;-870.500;3921.960
2022-06-10;2022-06-10;5490990004;PETER HENELL;2000.000;4792.460
2022-06-10;2022-06-10;5490990789;AB STORSTOCK;-39.000;2792.460
2022-06-09;2022-06-09;5484248713;BERGSHAMRA P/22-06-07;-80.000;2831.460
2022-06-09;2022-06-09;5484760580;RESTAURANG S/22-06-08;-109.000;2911.460
2022-06-09;2022-06-09;5484405165;COOP KONSUM /22-06-08;-22.000;3020.460
2022-06-09;2022-06-09;5490990789;AB STORSTOCK;-39.000;3042.460
2022-06-08;2022-06-08;5484238815;APOTEKSGRUPP/22-06-07;-82.010;3081.460
2022-06-07;2022-06-06;5484233592;BELLISIMO   /22-06-05;-95.000;3163.470
2022-06-07;2022-06-06;5490990789;1234557674;-70.000;3258.470
2022-06-02;2022-06-02;5484482277;COOP KONSUM /22-06-01;-33.280;3328.470
2022-05-30;2022-05-29;5484629187;COOP KONSUM /22-05-27;-67.850;3361.750
2022-05-30;2022-05-28;5484182815;SODER SPORTF/22-05-25;-3281.000;3429.600
2022-05-30;2022-05-28;5484386695;CARLS DELI  /22-05-27;-175.000;6710.600
2022-05-27;2022-05-27;5484590030;ICA NARA BER/22-05-26;-61.900;6885.600
2022-05-27;2022-05-27;5490990789;JIGHEAD AB;-30.000;6947.500
2022-05-27;2022-05-26;5484279181;SYSTEMBOLAGE/22-05-25;-6.000;6977.500
2022-05-27;2022-05-26;5484279180;SYSTEMBOLAGE/22-05-25;-336.600;6983.500
2022-05-27;2022-05-26;5484062059;BELLISIMO   /22-05-25;-99.000;7320.100
2022-05-25;2022-05-25;5490990004;PETER HENELL;6000.000;7419.100
2022-05-23;2022-05-22;5484501892;COOP KONSUM /22-05-21;-197.060;1419.100
2022-05-19;2022-05-19;5484155648;LIKOS THAI R/22-05-18;-129.000;1616.160
2022-05-18;2022-05-18;5484582110;COOP KONSUM /22-05-17;-120.640;1745.160
2022-05-16;2022-05-16;5484214733;BELLISIMO   /22-05-15;-120.000;1865.800
2022-05-16;2022-05-16;5484857797;ICA NARA BER/22-05-15;-48.400;1985.800
2022-05-16;2022-05-15;5484127524;COOP KONSUM /22-05-13;-29.500;2034.200
2022-05-16;2022-05-14;5484106715;EAT BY SODEX/22-05-12;-94.000;2063.700
2022-05-16;2022-05-14;5484659262;APOTEKSGRUPP/22-05-13;-1139.000;2157.700
2022-05-16;2022-05-14;5484638980;RESTAURANG S/22-05-13;-109.000;3296.700
2022-05-16;2022-05-14;5490990789;46704787989;-160.000;3405.700
2022-05-13;2022-05-13;5490990789;46704787989;-450.000;3565.700
2022-05-13;2022-05-13;5490990004;PETER HENELL;3000.000;4015.700
2022-05-12;2022-05-12;5484623514;PRESSKLUBBEN/22-05-11;-164.000;1015.700
2022-05-11;2022-05-11;5484410335;ICA NARA BER/22-05-10;-34.900;1179.700
2022-05-10;2022-05-10;5484747560;SYSTRARNA P /22-05-09;-1440.000;1214.600
2022-05-09;2022-05-09;5490990789;AB STORSTOCK;-39.000;2654.600
2022-05-09;2022-05-09;5490990789;AB STORSTOCK;-39.000;2693.600
2022-05-09;2022-05-07;5484746971;EAT BY SODEX/22-05-05;-94.000;2732.600
2022-05-09;2022-05-07;5484012310;BELLISIMO   /22-05-06;-110.000;2826.600
2022-05-05;2022-05-05;5484446088;COOP KONSUM /22-05-03;-57.900;2936.600
2022-05-05;2022-05-05;5484354244;BILTEMA INFR/22-04-23;-72.800;2994.500
2022-05-05;2022-05-05;5484725507;RESTAURANG S/22-05-04;-250.000;3067.300
2022-05-05;2022-05-05;5490990789;AB STORSTOCK;-39.000;3317.300
2022-05-05;2022-05-05;5490990789;AB STORSTOCK;-39.000;3356.300
2022-05-04;2022-05-04;5484129392;SILK WAY AB /22-05-03;-139.000;3395.300
2022-05-03;2022-05-03;5484038447;BELLISIMO   /22-05-02;-110.000;3534.300
2022-05-02;2022-05-02;5490990004;PETER HENELL;3000.000;3644.300
2022-05-02;2022-05-01;5484270418;COOP KONSUM /22-04-30;-26.500;644.300
2022-05-02;2022-04-30;5484385283;RESTAURANG S/22-04-29;-109.000;670.800
2022-05-02;2022-04-30;5484833597;EAT BY SODEX/22-04-28;-94.000;779.800
2022-04-28;2022-04-28;5484074800;RESTAURANG S/22-04-27;-109.000;873.800
2022-04-28;2022-04-28;5484585424;COOP KONSUM /22-04-27;-26.090;982.800
2022-04-28;2022-04-28;5490990789;AB STORSTOCK;-39.000;1008.890
2022-04-28;2022-04-28;5490990789;AB STORSTOCK;-39.000;1047.890
2022-04-27;2022-04-27;5484771266;BELLISIMO   /22-04-26;-110.000;1086.890
2022-04-26;2022-04-26;5484028902;RESTAURANG S/22-04-25;-109.000;1196.890
2022-04-26;2022-04-26;5484519256;COOP KONSUM /22-04-25;-29.500;1305.890
2022-04-25;2022-04-24;5484814966;EAT BY SODEX/22-04-22;-94.000;1335.390
2022-04-25;2022-04-23;5484304341;COOP KONSUM /22-04-22;-16.010;1429.390
2022-04-22;2022-04-22;5484032376;RESTAURANG S/22-04-21;-109.000;1445.400
2022-04-22;2022-04-22;5490990789;46707591203;180.000;1554.400
2022-04-22;2022-04-22;5490990789;AB STORSTOCK;-39.000;1374.400
2022-04-21;2022-04-21;5484321950;OKQ8        /22-04-18;-979.420;1413.400
2022-04-21;2022-04-21;5484670710;BELLISIMO   /22-04-20;-99.000;2392.820
2022-04-21;2022-04-21;5484347829;COOP KONSUM /22-04-20;-56.000;2491.820
2022-04-19;2022-04-18;5490990789;AB STORSTOCK;-39.000;2547.820
2022-04-19;2022-04-18;5490990004;PETER HENELL;1000.000;2586.820
2022-04-19;2022-04-15;5484534064;RESTAURANG S/22-04-14;-190.000;1586.820
2022-04-19;2022-04-15;5484534058;RESTAURANG S/22-04-14;-109.000;1776.820
2022-04-19;2022-04-15;5484066000;SJOSTADEN SK/22-04-13;-95.000;1885.820
2022-04-14;2022-04-14;5484514043;BELLISIMO   /22-04-13;-80.000;1980.820
2022-04-13;2022-04-13;5484087450;PITCHERS MAR/22-04-10;-144.000;2060.820
2022-04-13;2022-04-13;5484544715;SYSTEMBOLAGE/22-04-12;-1438.400;2204.820
2022-04-13;2022-04-13;5484532154;APOTEKSGRUPP/22-04-12;-188.450;3643.220
2022-04-13;2022-04-13;5484511261;RESTAURANG S/22-04-12;-109.000;3831.670
2022-04-13;2022-04-13;5484174927;COOP KONSUM /22-04-12;-24.830;3940.670
2022-04-13;2022-04-13;5490990789;46705651833;300.000;3965.500
2022-04-12;2022-04-12;5484463044;RESTAURANG S/22-04-11;-109.000;3665.500
2022-04-12;2022-04-12;5490990004;PETER HENELL;2000.000;3774.500
2022-04-12;2022-04-12;5490990789;AB STORSTOCK;-39.000;1774.500
2022-04-11;2022-04-11;5484729226;VINTERVIKENS/22-04-10;-64.000;1813.500
2022-04-11;2022-04-11;5484698274;BELLISIMO   /22-04-10;-110.000;1877.500
2022-04-11;2022-04-10;5490990789;AB STORSTOCK;-39.000;1987.500
2022-04-11;2022-04-10;5490990789;AB STORSTOCK;-39.000;2026.500
2022-04-11;2022-04-09;5484012995;RESTAURANG S/22-04-08;-355.000;2065.500
2022-04-11;2022-04-09;5484012988;RESTAURANG S/22-04-08;-109.000;2420.500
2022-04-11;2022-04-09;5484488436;COOP KONSUM /22-04-08;-33.280;2529.500
2022-04-08;2022-04-08;5484282477;BELLISIMO   /22-04-07;-99.000;2562.780
2022-04-08;2022-04-08;5484771884;THE DOORS   /22-04-06;-94.000;2661.780
2022-04-06;2022-04-06;5484070459;COOP KONSUM /22-04-05;-105.320;2755.780
2022-04-04;2022-04-03;5484134837;RESTAURANG S/22-04-02;-60.000;2861.100
2022-04-04;2022-04-03;5484134836;RESTAURANG S/22-04-02;-250.000;2921.100
2022-04-04;2022-04-03;5484635230;COOP KONSUM /22-04-02;-83.650;3171.100
2022-04-04;2022-04-02;5484648317;EAT BY SODEX/22-03-31;-83.000;3254.750
2022-04-04;2022-04-02;5484682342;RESTAURANG S/22-04-01;-109.000;3337.750
2022-03-29;2022-03-29;5484868979;TJOGET      /22-03-25;-310.000;3446.750
2022-03-29;2022-03-29;5484145713;COOP KONSUM /22-03-27;-53.000;3756.750
2022-03-28;2022-03-26;5484033317;RESTAURANG S/22-03-25;-168.000;3809.750
2022-03-28;2022-03-26;5484454106;COOP KONSUM /22-03-25;-29.140;3977.750
2022-03-25;2022-03-25;5484801109;RESTAURANG S/22-03-24;-250.000;4006.890
2022-03-25;2022-03-25;5484444544;COOP KONSUM /22-03-24;-17.000;4256.890
2022-03-25;2022-03-25;5490990789;AB STORSTOCK;-39.000;4273.890
2022-03-23;2022-03-23;5484643664;COOP KONSUM /22-03-22;-8.500;4312.890
2022-03-22;2022-03-22;5484402490;APOTEKSGRUPP/22-03-21;-562.470;4321.390
2022-03-22;2022-03-22;5484358957;BELLISIMO   /22-03-21;-99.000;4883.860
2022-03-22;2022-03-22;5490990789;1233700879;-892.000;4982.860
2022-03-21;2022-03-21;5484290901;COOP KONSUM /22-03-20;-43.850;5874.860
2022-03-21;2022-03-20;5484746847;COOP KONSUM /22-03-18;-68.720;5918.710
2022-03-21;2022-03-19;5484559706;EAT BY SODEX/22-03-17;-94.000;5987.430
2022-03-21;2022-03-19;5484198275;RESTAURANG S/22-03-18;-250.000;6081.430
2022-03-17;2022-03-17;5484134652;RALPH LAUREN/22-03-16;-5980.000;6331.430
2022-03-17;2022-03-17;5484126060;NK STOCKHOLM/22-03-16;-3398.000;12311.430
2022-03-17;2022-03-17;5484810409;J LINDEBERG /22-03-16;-7000.000;15709.430
2022-03-17;2022-03-17;5484720721;TOKYO DINER /22-03-16;-145.000;22709.430
2022-03-16;2022-03-16;5490990004;PETER HENELL;6000.000;22854.430
2022-03-16;2022-03-16;5490990004;PETER HENELL;10000.000;16854.430
2022-03-14;2022-03-13;5484245193;RESTAURANG S/22-03-12;-250.000;6854.430
2022-03-14;2022-03-12;5484405214;COOP KONSUM /22-03-11;-123.150;7104.430
2022-03-11;2022-03-11;5484041811;THE DOORS   /22-03-09;-94.000;7227.580
2022-03-11;2022-03-11;5484041809;THE DOORS   /22-03-09;-94.000;7321.580
2022-03-09;2022-03-09;5490990789;46736627274;1000.000;7415.580
2022-03-09;2022-03-09;5490990789;46705979742;1000.000;6415.580
2022-03-09;2022-03-09;5490990789;46703112869;1000.000;5415.580
2022-03-09;2022-03-09;5490990789;46721428359;1000.000;4415.580
2022-03-07;2022-03-05;5484674138;RESTAURANG S/22-03-04;-370.000;3415.580
2022-03-03;2022-03-03;5484175153;BELLISIMO   /22-03-02;-95.000;3785.580
2022-02-28;2022-02-28;5484401626;COOP KONSUM /22-02-27;-89.300;3880.580
2022-02-28;2022-02-27;5484502066;COOP KONSUM /22-02-25;-27.500;3969.880
2022-02-28;2022-02-26;5484511644;RESTAURANG S/22-02-25;-250.000;3997.380
2022-02-25;2022-02-25;5484211620;RESTAURANG S/22-02-24;-250.000;4247.380
2022-02-22;2022-02-22;5484636198;COOP KONSUM /22-02-21;-53.450;4497.380
2022-02-21;2022-02-21;5484597450;BELLISIMO   /22-02-20;-125.000;4550.830
2022-02-21;2022-02-20;5490990789;46707815940;400.000;4675.830
2022-02-21;2022-02-19;5490990789;46736227759;540.000;4275.830
2022-02-21;2022-02-19;5484019370;COOP KONSUM /22-02-17;-26.500;3735.830
2022-02-18;2022-02-18;5484581622;APOTEKSGRUPP/22-02-17;-41.270;3762.330
2022-02-18;2022-02-18;5484234606;THE DOORS   /22-02-16;-94.000;3803.600
2022-02-18;2022-02-18;5484234602;THE DOORS   /22-02-16;-94.000;3897.600
2022-02-18;2022-02-18;5484234585;THE DOORS   /22-02-16;-94.000;3991.600
2022-02-14;2022-02-14;5484355267;HM SE0060   /22-02-14;-199.000;4085.600
2022-02-14;2022-02-14;5490990004;PETER HENELL;2000.000;4284.600
2022-02-14;2022-02-13;5484262311;THE DOORS   /22-02-11;-230.000;2284.600
2022-02-14;2022-02-13;5484262310;THE DOORS   /22-02-11;-94.000;2514.600
2022-02-11;2022-02-11;5484780145;TRANAN      /22-02-09;-162.000;2608.600
2022-02-11;2022-02-11;5484482588;COOP KONSUM /22-02-10;-71.950;2770.600
2022-02-11;2022-02-11;5484482504;COOP KONSUM /22-02-10;-42.160;2842.550
2022-02-11;2022-02-11;5490990789;46704619499;-200.000;2884.710
2022-02-10;2022-02-10;5484733372;THE DOORS   /22-02-09;-96.000;3084.710
2022-02-10;2022-02-10;5490990789;46720388884;-600.000;3180.710
2022-02-08;2022-02-08;5484856939;COOP KONSUM /22-02-07;-53.450;3780.710
2022-02-08;2022-02-08;5484856890;COOP KONSUM /22-02-07;-9.500;3834.160
2022-02-07;2022-02-07;5490990004;PETER HENELL;3000.000;3843.660
2022-02-07;2022-02-06;5484726118;BILTEMA INFR/22-02-05;-348.800;843.660
2022-02-07;2022-02-06;5484724102;BAUHAUS UPPL/22-02-05;-418.000;1192.460
2022-01-31;2022-01-30;5484751246;COOP KONSUM /22-01-29;-135.300;1610.460
2022-01-31;2022-01-29;5484498327;SYSTEMBOLAGE/22-01-28;-1254.000;1745.760
2022-01-31;2022-01-29;5484455832;RESTAURANG S/22-01-28;-250.000;2999.760
2022-01-28;2022-01-28;5484660820;BELLISIMO   /22-01-27;-99.000;3249.760
2022-01-28;2022-01-28;5490990789;AB STORSTOCK;-39.000;3348.760
2022-01-27;2022-01-27;5484859435;THE DOORS   /22-01-26;-96.000;3387.760
2022-01-26;2022-01-26;5490990789;46721428359;400.000;3483.760
2022-01-25;2022-01-25;5484355903;OKQ8        /22-01-22;-344.000;3083.760
2022-01-24;2022-01-22;5484838888;RESTAURANG S/22-01-21;-310.000;3427.760
2022-01-20;2022-01-20;5484682681;COOP KONSUM /22-01-19;-69.900;3737.760
2022-01-17;2022-01-15;5484702490;RESTAURANG S/22-01-14;-190.000;3807.660
2022-01-14;2022-01-14;5484282356;COOP KONSUM /22-01-13;-121.500;3997.660
2022-01-07;2022-01-07;5484732688;RESTAURANG S/22-01-06;-250.000;4119.160
2022-01-03;2022-01-03;5490990004;PETER HENELL;3000.000;4369.160
2022-01-03;2022-01-02;5490990789;46707591203;-150.000;1369.160
2022-01-03;2022-01-01;5484251605;COOP KONSUM /21-12-31;-177.700;1519.160
2021-12-29;2021-12-29;5484487226;COOP KONSUM /21-12-28;-37.950;1696.860
2021-12-28;2021-12-28;5484824420;COOP KONSUM /21-12-27;-52.900;1734.810
2021-12-27;2021-12-27;5484067618;CIRCLE K SOL/21-12-26;-335.700;1787.710
2021-12-27;2021-12-27;5484059114;CIRCLE K SOL/21-12-26;-29.400;2123.410
2021-12-27;2021-12-25;5484860908;COOP KONSUM /21-12-23;-34.950;2152.810
2021-12-27;2021-12-24;5484765538;BERGSHAMRA B/21-12-23;-530.000;2187.760
2021-12-27;2021-12-24;5484066613;CIRCLE K SOL/21-12-23;-3407.000;2717.760
2021-12-27;2021-12-24;5490990789;46760450519;-1000.000;6124.760
2021-12-23;2021-12-23;5490990004;PETER HENELL;4000.000;7124.760
2021-12-23;2021-12-23;5490990789;AB STORSTOCK;-38.000;3124.760
2021-12-21;2021-12-21;5484418288;APOTEKSGRUPP/21-12-20;-255.100;3162.760
2021-12-20;2021-12-20;5484152848;BELLISIMO   /21-12-19;-110.000;3417.860
2021-12-20;2021-12-18;5484600160;WEBHALLEN   /21-12-17;-874.000;3527.860
2021-12-20;2021-12-18;5484041473;SYSTEMBOLAGE/21-12-17;-385.000;4401.860
2021-12-15;2021-12-15;5490990789;46704787989;200.000;4786.860
2021-12-14;2021-12-14;5484334263;BELLISIMO   /21-12-13;-99.000;4586.860
2021-12-13;2021-12-12;5484587128;THE DUBLINER/21-12-10;-106.000;4685.860
2021-12-13;2021-12-12;5484587087;THE DUBLINER/21-12-10;-74.000;4791.860
2021-12-13;2021-12-12;5484363555;BELLISIMO   /21-12-11;-110.000;4865.860
2021-12-13;2021-12-11;5490990004;PETER HENELL;3000.000;4975.860
2021-12-08;2021-12-08;5484151339;SYSTEMBOLAGE/21-12-07;-928.000;1975.860
2021-12-06;2021-12-06;5484047416;RESTAURANG S/21-12-05;-190.000;2903.860
2021-12-06;2021-12-04;5484836114;RESTAURANG S/21-12-03;-250.000;3093.860
2021-12-03;2021-12-03;5484482602;THE DOORS   /21-12-01;-96.000;3343.860
2021-12-03;2021-12-03;5484104952;BERGSHAMRA P/21-12-02;-115.000;3439.860
2021-12-01;2021-12-01;5490990789;46721428359;900.000;3554.860
2021-12-01;2021-12-01;5490990789;46705979742;439.000;2654.860
2021-12-01;2021-12-01;5484565914;COOP KONSUM /21-11-30;-76.560;2215.860
2021-11-29;2021-11-27;5490990789;1234557674;-110.000;2292.420
2021-11-26;2021-11-26;5484545713;THE DOORS   /21-11-24;-150.000;2402.420
2021-11-26;2021-11-26;5484842484;BELLISIMO   /21-11-25;-99.000;2552.420
2021-11-22;2021-11-21;5484715905;THE QUEENS H/21-11-19;-168.000;2651.420
2021-11-18;2021-11-18;5484748834;SYSTRARNA P /21-11-17;-2185.000;2819.420
2021-11-15;2021-11-15;5484632412;BELLISIMO   /21-11-14;-105.000;5004.420
2021-11-15;2021-11-15;5490990789;46707251259;-53.000;5109.420
2021-11-11;2021-11-11;5484398101;IKKI SUSHI &/21-11-10;-110.000;5162.420
2021-11-09;2021-11-09;5484558325;COOP KONSUM /21-11-08;-87.610;5272.420
2021-11-08;2021-11-07;5484842267;LINJE TIO AB/21-11-05;-310.000;5360.030
2021-11-08;2021-11-07;5484344928;RESTAURANG S/21-11-06;-199.000;5670.030
2021-11-08;2021-11-06;5484864787;ZTL HELIOWOR/21-11-05;-50.000;5869.030
2021-11-08;2021-11-06;5484788514;IZ  HELIOWOR/21-11-05;-50.000;5919.030
2021-11-08;2021-11-06;5484788512;IZ  HELIOWOR/21-11-05;-150.000;5969.030
2021-11-08;2021-11-06;5484788510;IZ  HELIOWOR/21-11-05;-50.000;6119.030
2021-11-08;2021-11-06;5484678290;SYSTEMBOLAGE/21-11-05;-627.000;6169.030
2021-11-05;2021-11-05;5484260335;BERGSHAMRA P/21-11-04;-100.000;6796.030
2021-11-02;2021-11-02;5484498838;ICA NARA BER/21-11-01;-139.000;6896.030
2021-11-01;2021-11-01;5484704831;COOP KONSUM /21-10-31;-27.500;7035.030
2021-11-01;2021-10-31;5484707091;PIERIAS LIVS/21-10-30;-45.000;7062.530
2021-11-01;2021-10-31;5484588288;ALEWALDS SPO/21-10-30;-10997.000;7107.530
2021-11-01;2021-10-30;5490990004;PETER HENELL;16000.000;18104.530
2021-10-29;2021-10-29;5484065456;BELLISIMO   /21-10-28;-105.000;2104.530
2021-10-28;2021-10-28;5484641916;THE DOORS   /21-10-27;-88.000;2209.530
2021-10-26;2021-10-26;5484428407;COOP KONSUM /21-10-25;-128.400;2297.530
2021-10-25;2021-10-23;5484148474;SYSTEMBOLAGE/21-10-22;-983.000;2425.930
2021-10-25;2021-10-23;5484107925;RESTAURANG S/21-10-22;-190.000;3408.930
2021-10-22;2021-10-22;5484852819;GOOGLE  GOOG/21-10-21;-19.000;3598.930
2021-10-18;2021-10-17;5490990004;PETER HENELL;3000.000;3617.930
2021-10-18;2021-10-16;5484796880;RESTAURANG S/21-10-15;-189.000;617.930
2021-10-11;2021-10-11;5484192792;BELLISIMO   /21-10-09;-114.000;806.930
2021-10-11;2021-10-11;5484783103;ICA NARA BER/21-10-09;-159.500;920.930
2021-10-06;2021-10-06;5484022646;LIKOS THAI R/21-10-05;-230.000;1080.430
2021-10-06;2021-10-06;5484810937;COOP KONSUM /21-10-05;-23.500;1310.430
2021-10-04;2021-10-04;5484211213;SYSTEMBOLAGE/21-10-02;-553.000;1333.930
2021-10-04;2021-10-04;5484857628;HEMKÖP MÖRBY/21-10-02;-352.050;1886.930
2021-10-04;2021-10-04;5484547624;BELLISIMO   /21-10-03;-90.000;2238.980
2021-10-01;2021-10-01;5484288525;APOTEKSGRUPP/21-09-30;-62.360;2328.980
2021-09-30;2021-09-30;5484239892;ALEWALDS SPO/21-09-29;-1347.000;2391.340
2021-09-28;2021-09-28;5484581691;OKQ8        /21-09-27;-345.070;3738.340
2021-09-27;2021-09-27;5484147470;COOP KONSUM /21-09-26;-25.950;4083.410
2021-09-27;2021-09-27;5490990004;PETER HENELL;3000.000;4109.360
2021-09-27;2021-09-24;5490990789;46704787989;-1200.000;1109.360
2021-09-22;2021-09-22;5484436448;GOOGLE  GOOG/21-09-21;-19.000;2309.360
2021-09-22;2021-09-22;5484305737;YAMASHIRO SU/21-09-21;-125.000;2328.360
2021-09-17;2021-09-17;5484604888;COOP KONSUM /21-09-16;-30.950;2453.360
2021-09-16;2021-09-16;5484879793;GUNNAR OLSSO/21-09-15;-810.000;2484.310
2021-09-13;2021-09-11;5490990789;1234557674;-90.000;3294.310
2021-09-08;2021-09-08;5490990789;1234557674;-90.000;3384.310
2021-09-07;2021-09-07;5484664421;ESPRESSO H 3/21-09-05;-32.000;3474.310
2021-09-07;2021-09-07;5484509169;JURESKOGS   /21-09-05;-139.000;3506.310
2021-09-06;2021-09-06;5484826700;COOP KONSUM /21-09-04;-12.350;3645.310
2021-09-06;2021-09-06;5484739367;BERGSHAMRA P/21-09-04;-80.000;3657.660
2021-09-06;2021-09-04;5484487086;BELLISIMO   /21-09-03;-90.000;3737.660
2021-09-03;2021-09-03;5484179200;COOP KONSUM /21-09-02;-51.900;3827.660
2021-09-03;2021-09-03;5490990789;46721428359;200.000;3879.560
2021-08-30;2021-08-30;5484607273;BAR NOMBRE  /21-08-28;-160.000;3679.560
2021-08-30;2021-08-30;5484426990;APOTEKSGRUPP/21-08-27;-753.500;3839.560
2021-08-30;2021-08-30;5484812454;BERGSHAMRA P/21-08-28;-80.000;4593.060
2021-08-30;2021-08-30;5484730596;5162 OLEARYS/21-08-27;-97.000;4673.060
2021-08-30;2021-08-30;5484730594;5162 OLEARYS/21-08-27;-194.000;4770.060
2021-08-30;2021-08-28;5484571039;BELLISIMO   /21-08-27;-95.000;4964.060
2021-08-30;2021-08-28;5490990789;46738674668;600.000;5059.060
2021-08-27;2021-08-27;5490990789;46704787989;-550.000;4459.060
2021-08-27;2021-08-27;5490990789;46721428359;700.000;5009.060
2021-08-27;2021-08-27;5490990789;46736627274;600.000;4309.060
2021-08-27;2021-08-27;5490990789;46704787989;1000.000;3709.060
2021-08-23;2021-08-23;5484857595;GOOGLE  GOOG/21-08-21;-19.000;2709.060
2021-08-23;2021-08-23;5484703336;BELLISIMO   /21-08-21;-99.000;2728.060
2021-08-20;2021-08-20;5484362050;SYSTEMBOLAGE/21-08-19;-1048.400;2827.060
2021-08-19;2021-08-19;5484106512;COOP KONSUM /21-08-18;-87.850;3875.460
2021-08-16;2021-08-16;5484291822;COOP KONSUM /21-08-14;-30.860;3963.310
2021-08-16;2021-08-14;5484035331;ITAMAE SUSHI/21-08-13;-169.000;3994.170
2021-08-16;2021-08-14;5484403820;TEXAS LONGHO/21-08-13;-72.000;4163.170
2021-08-16;2021-08-14;5484395127;PRIMO CIAO C/21-08-13;-243.000;4235.170
2021-08-16;2021-08-14;5490990004;PETER HENELL;3000.000;4478.170
2021-08-13;2021-08-13;5490990789;46705438947;68.000;1478.170
2021-08-13;2021-08-13;5490990789;46736227759;-250.000;1410.170
2021-08-13;2021-08-13;5490990789;46736227759;-200.000;1660.170
2021-08-12;2021-08-12;5484794111;COOP KONSUM /21-08-11;-22.900;1860.170
2021-08-10;2021-08-10;5490990789;AVANZA BANK;-500.000;1883.070
2021-08-09;2021-08-09;5484084264;BERGSHAMRA P/21-08-07;-170.000;2383.070
2021-08-09;2021-08-09;5484028224;BELLISIMO   /21-08-08;-90.000;2553.070
2021-08-05;2021-08-05;5484879908;COOP KONSUM /21-08-03;-33.140;2643.070
2021-08-05;2021-08-05;5484795841;BELLISIMO   /21-08-04;-99.000;2676.210
2021-08-03;2021-08-03;5484093754;NEW MILL GRI/21-08-02;-95.000;2775.210
2021-08-02;2021-08-02;5490990789;AB STORSTOCK;-38.000;2870.210
2021-08-02;2021-08-02;5490990789;46720388884;-108.000;2908.210
2021-07-30;2021-07-30;5490990789;AB STORSTOCK;-38.000;3016.210
2021-07-29;2021-07-29;5484679538;XXL SPORT & /21-07-28;-199.000;3054.210
2021-07-29;2021-07-29;5484427833;OOB ARNINGE /21-07-28;-205.000;3253.210
2021-07-29;2021-07-29;5484011124;STADIUM OUTL/21-07-28;-599.000;3458.210
2021-07-29;2021-07-29;5484846743;SYSTEMBOLAGE/21-07-28;-408.000;4057.210
2021-07-28;2021-07-28;5490990004;PETER HENELL;4000.000;4465.210
2021-07-27;2021-07-27;5484464620;COOP KONSUM /21-07-26;-21.520;465.210
2021-07-26;2021-07-26;5484046838;COOP KONSUM /21-07-24;-3.400;486.730
2021-07-26;2021-07-26;5484302453;KREATIMA    /21-07-25;-79.900;490.130
2021-07-26;2021-07-26;5484104341;XXL SPORT & /21-07-25;-307.000;570.030
2021-07-26;2021-07-26;5484776229;ALEWALDS SPO/21-07-25;-918.000;877.030
2021-07-26;2021-07-26;5484711486;IKKI SUSHI &/21-07-25;-258.000;1795.030
2021-07-26;2021-07-25;5490990789;46720388884;110.000;2053.030
2021-07-26;2021-07-24;5490990789;46702804339;-500.000;1943.030
2021-07-26;2021-07-24;5484446969;KATRINEHOLMS/21-07-23;-100.000;2443.030
2021-07-23;2021-07-23;5490990789;46768847083;100.000;2543.030
2021-07-23;2021-07-23;5490990789;FOODORA AB;-228.000;2443.030
2021-07-23;2021-07-23;5490990789;46768847083;-600.000;2671.030
2021-07-22;2021-07-22;5484658856;GOOGLE  GOOG/21-07-21;-19.000;3271.030
2021-07-19;2021-07-19;5484804983;MAXI ICA STO/21-07-17;-401.370;3290.030
2021-07-16;2021-07-16;5484393538;LIDL 192 / K/21-07-15;-33.000;3691.400
2021-07-15;2021-07-15;5490990004;PETER HENELL;3000.000;3724.400
2021-07-14;2021-07-14;5484826230;INTERSPORT K/21-07-13;-499.000;724.400
2021-07-14;2021-07-14;5484556084;MAXI ICA STO/21-07-13;-323.890;1223.400
2021-07-13;2021-07-13;5484084346;QSTAR KATRIN/21-07-11;-885.050;1547.290
2021-07-12;2021-07-12;5484268049;KATRINEHOLMS/21-07-11;-120.000;2432.340
2021-07-09;2021-07-09;5484607968;MAXI ICA STO/21-07-07;-568.570;2552.340
2021-07-08;2021-07-08;5484071597;APOTEK HJART/21-07-07;-371.000;3120.910
2021-07-07;2021-07-07;5484677684;DOLLARSTORE /21-07-06;-110.000;3491.910
2021-07-05;2021-07-05;5484378267;VINGÅKERS FA/21-07-03;-498.000;3601.910
2021-07-05;2021-07-03;5484636491;MAXI ICA STO/21-07-01;-597.150;4099.910
2021-07-02;2021-07-02;5484494786;OOB KATRINEH/21-07-01;-89.000;4697.060
2021-07-01;2021-07-01;5484026268;BELLISIMO   /21-06-30;-105.000;4786.060
2021-06-29;2021-06-29;5490990789;46707815940;-530.000;4891.060
2021-06-28;2021-06-26;5484300672;BERGSHAMRA P/21-06-25;-90.000;5421.060
2021-06-28;2021-06-25;5484420901;COOP KONSUM /21-06-24;-25.950;5511.060
2021-06-28;2021-06-25;5484420884;COOP KONSUM /21-06-24;-21.950;5537.010
2021-06-28;2021-06-25;5484420881;COOP KONSUM /21-06-24;-21.950;5558.960
2021-06-28;2021-06-25;5484420879;COOP KONSUM /21-06-24;-105.750;5580.910
2021-06-24;2021-06-24;5490990004;PETER HENELL;5000.000;5686.660
2021-06-24;2021-06-24;5490990789;46708338938;-1050.000;686.660
2021-06-22;2021-06-22;5484686521;GOOGLE  GOOG/21-06-21;-19.000;1736.660
2021-06-22;2021-06-22;5484445793;COOP KONSUM /21-06-21;-52.900;1755.660
2021-06-21;2021-06-21;5484789512;SPIS I KIRUN/21-06-20;-68.000;1808.560
2021-06-21;2021-06-21;5484187089;ANNIS GRILL /21-06-20;-92.000;1876.560
2021-06-21;2021-06-21;5490990789;POSTNORD SVE;-93.000;1968.560
2021-06-21;2021-06-19;5484567585;SPIS I KIRUN/21-06-17;-287.000;2061.560
2021-06-18;2021-06-18;5484695560;STOP 22     /21-06-17;-255.000;2348.560
2021-06-18;2021-06-18;5484681762;OUTDOORENSHO/21-06-17;-118.000;2603.560
2021-06-17;2021-06-17;5484345635;BERGSHAMRA P/21-06-16;-85.000;2721.560
2021-06-17;2021-06-17;5484828134;HMSHOST ARLA/21-06-17;-133.000;2806.560
2021-06-16;2021-06-16;5484802193;NYX UNATTEND/21-06-15;-5.000;2939.560
2021-06-16;2021-06-16;5484669335;XXL SPORT & /21-06-15;-2133.000;2944.560
2021-06-16;2021-06-16;5484497160;DJURGARDSBRO/21-06-15;-170.000;5077.560
2021-06-16;2021-06-16;5484841597;BELLISIMO   /21-06-15;-95.000;5247.560
2021-06-15;2021-06-15;5490990004;PETER HENELL;3000.000;5342.560
2021-06-14;2021-06-14;5484114522;BELLISIMO   /21-06-13;-100.000;2342.560
2021-06-11;2021-06-11;5484776690;APOTEKSGRUPP/21-06-10;-606.330;2442.560
2021-06-11;2021-06-11;5484466834;COOP KONSUM /21-06-10;-72.880;3048.890
2021-06-10;2021-06-10;5484865217;COOP KONSUM /21-06-08;-8.450;3121.770
2021-06-09;2021-06-09;5490990789;46702984673;-7235.000;3130.220
2021-06-09;2021-06-09;5490990004;PETER HENELL;8000.000;10365.220
2021-06-09;2021-06-09;5484276304;COOP KONSUM /21-06-07;-26.350;2365.220
2021-06-09;2021-06-09;5484702502;SYSTEMBOLAGE/21-06-08;-796.200;2391.570
2021-06-08;2021-06-08;5484147437;SODER SPORTF/21-06-05;-1494.000;3187.770
2021-06-07;2021-06-07;5484510366;GUNNAR OLSSO/21-06-05;-295.000;4681.770
2021-06-07;2021-06-07;5484267126;ALEWALDS SPO/21-06-05;-1536.000;4976.770
2021-06-07;2021-06-05;5484185913;BELLISIMO   /21-06-04;-95.000;6512.770
2021-06-07;2021-06-05;5490990004;PETER HENELL;3000.000;6607.770
2021-06-04;2021-06-04;5490990789;46721428359;-200.000;3607.770
2021-06-03;2021-06-03;5484447421;BELLISIMO   /21-06-02;-105.000;3807.770
2021-05-31;2021-05-29;5484727460;APOTEKSGRUPP/21-05-28;-29.900;3912.770
2021-05-28;2021-05-28;5484706317;COOP KONSUM /21-05-26;-2.400;3942.670
2021-05-26;2021-05-26;5484314311;COOP KONSUM /21-05-24;-18.350;3945.070
2021-05-26;2021-05-26;5484759215;SYSTEMBOLAGE/21-05-25;-550.000;3963.420
2021-05-26;2021-05-26;5484483168;HEMKÖP MÖRBY/21-05-25;-624.820;4513.420
2021-05-25;2021-05-25;5490990004;PETER HENELL;2000.000;5138.240
2021-05-24;2021-05-24;5484558321;BELLISIMO   /21-05-22;-99.000;3138.240
2021-05-24;2021-05-22;5484333085;GOOGLE  GOOG/21-05-21;-19.000;3237.240
2021-05-19;2021-05-19;5484048144;OKQ8        /21-05-15;-371.560;3256.240
2021-05-17;2021-05-17;5484400737;BELLISIMO   /21-05-15;-100.000;3627.800
2021-05-17;2021-05-15;5484183255;BELLISIMO   /21-05-14;-95.000;3727.800
2021-05-17;2021-05-15;5490990004;PETER HENELL;2000.000;3822.800
2021-05-14;2021-05-14;5484824224;ICA NARA BER/21-05-13;-55.900;1822.800
2021-05-14;2021-05-13;5484616108;BERGSHAMRA P/21-05-12;-55.000;1878.700
2021-05-14;2021-05-13;5484081066;APOTEKSGRUPP/21-05-12;-348.030;1933.700
2021-05-12;2021-05-12;5484242244;SYSTRARNA P /21-05-11;-870.000;2281.730
2021-05-12;2021-05-12;5484187745;SYSTEMBOLAGE/21-05-11;-1461.400;3151.730
2021-05-12;2021-05-12;5484123439;BELLISIMO   /21-05-11;-95.000;4613.130
2021-05-12;2021-05-12;5490990789;POSTNORD SVE;-125.000;4708.130
2021-05-11;2021-05-11;5490990004;PETER HENELL;2000.000;4833.130
2021-05-10;2021-05-10;5484088941;COOP KONSUM /21-05-08;-47.600;2833.130
2021-05-10;2021-05-08;5484503253;BELLISIMO   /21-05-07;-90.000;2880.730
2021-05-03;2021-05-03;5484018308;ATLANTIS AB /21-04-30;-5472.000;2970.730
2021-05-03;2021-05-03;5484273457;BERGSHAMRA P/21-05-01;-80.000;8442.730
2021-04-30;2021-04-30;5490990004;PETER HENELL;4000.000;8522.730
2021-04-30;2021-04-30;5490990004;PETER HENELL;4000.000;4522.730
2021-04-29;2021-04-29;5484778511;HOKAIDO SUSH/21-04-28;-132.000;522.730
2021-04-28;2021-04-28;5484154300;SYSTEMBOLAGE/21-04-23;-1052.600;654.730
2021-04-27;2021-04-27;5490990789;1234557674;-95.000;1707.330
2021-04-26;2021-04-26;5484214060;BELLISIMO   /21-04-24;-99.000;1802.330
2021-04-26;2021-04-26;5484706241;DJURET      /21-04-23;-300.000;1901.330
2021-04-26;2021-04-26;5484706240;DJURET      /21-04-23;-90.000;2201.330
2021-04-26;2021-04-24;5484510958;BERGSHAMRA P/21-04-23;-85.000;2291.330
2021-04-22;2021-04-22;5484491462;GOOGLE  GOOG/21-04-21;-19.000;2376.330
2021-04-20;2021-04-20;5484711264;COOP KONSUM /21-04-19;-166.900;2395.330
2021-04-20;2021-04-20;5484587467;BERGSHAMRA P/21-04-19;-85.000;2562.230
2021-04-19;2021-04-17;5484239807;BELLISIMO   /21-04-16;-99.000;2647.230
2021-04-16;2021-04-16;5484863062;BELLISIMO   /21-04-15;-95.000;2746.230
2021-04-15;2021-04-15;5484780968;OCH HIMMELEN/21-04-13;-850.000;2841.230
2021-04-15;2021-04-15;5484775977;BERGSHAMRA P/21-04-14;-85.000;3691.230
2021-04-15;2021-04-15;5484653841;WIKIMEDIA 87/21-04-15;-104.000;3776.230
2021-04-15;2021-04-15;5490990004;PETER HENELL;2000.000;3880.230
2021-04-14;2021-04-14;5484263110;BERGSHAMRA P/21-04-13;-90.000;1880.230
2021-04-13;2021-04-13;5484597822;ALTRARUNNING/21-04-12;-2148.000;1970.230
2021-04-12;2021-04-10;5484581105;COOP KONSUM /21-04-09;-262.110;4118.230
2021-04-09;2021-04-09;5490990004;PETER HENELL;2000.000;4380.340
2021-04-06;2021-04-05;5484855857;ICA NARA BER/21-04-03;-98.300;2380.340
2021-04-06;2021-04-04;5490990789;46760450519;-200.000;2478.640
2021-04-06;2021-04-02;5484632172;APOTEKSGRUPP/21-04-01;-566.640;2678.640
2021-04-06;2021-04-02;5484308592;COOP KONSUM /21-04-01;-247.650;3245.280
2021-03-29;2021-03-27;5490990789;46760450519;-300.000;3492.930
2021-03-29;2021-03-27;5484099321;COOP KONSUM /21-03-26;-11.900;3792.930
2021-03-25;2021-03-25;5484575113;COOP KONSUM /21-03-24;-91.820;3804.830
2021-03-25;2021-03-25;5490990004;PETER HENELL;3000.000;3896.650
2021-03-22;2021-03-22;5484340351;COOP KONSUM /21-03-20;-322.000;896.650
2021-03-22;2021-03-22;5484574767;GOOGLE  GOOG/21-03-21;-19.000;1218.650
2021-03-22;2021-03-20;5484600491;BELLISIMO   /21-03-19;-99.000;1237.650
2021-03-17;2021-03-17;5484211117;BELLISIMO   /21-03-16;-95.000;1336.650
2021-03-15;2021-03-15;5484768102;APOTEKSGRUPP/21-03-13;-690.390;1431.650
2021-03-15;2021-03-15;5484521735;COOP KONSUM /21-03-13;-306.380;2122.040
2021-03-15;2021-03-13;5484631989;BELLISIMO   /21-03-12;-99.000;2428.420
2021-03-12;2021-03-12;5484845283;BERGSHAMRA P/21-03-11;-90.000;2527.420
2021-03-11;2021-03-11;5490990004;PETER HENELL;2000.000;2617.420
2021-03-08;2021-03-07;5490990789;46760450519;-300.000;617.420
2021-03-08;2021-03-06;5484083303;BELLISIMO   /21-03-05;-99.000;917.420
2021-03-08;2021-03-06;5484769514;ICA NARA BER/21-03-05;-98.300;1016.420
2021-03-05;2021-03-05;5484247222;BERGSHAMRA P/21-03-04;-109.000;1114.720
2021-03-01;2021-03-01;5484403927;CIRCLE K STO/21-02-27;-919.000;1223.720
2021-03-01;2021-03-01;5484847268;CIRCLE K STO/21-02-28;-60.120;2142.720
2021-03-01;2021-03-01;5490990789;46721428359;-115.000;2202.840
2021-03-01;2021-02-27;5484120056;COOP KONSUM /21-02-25;-21.900;2317.840
2021-03-01;2021-02-27;5484120043;COOP KONSUM /21-02-25;-22.250;2339.740
2021-03-01;2021-02-27;5484097134;BELLISIMO   /21-02-26;-95.000;2361.990
2021-03-01;2021-02-27;5490990789;46709124799;435.000;2456.990
2021-02-26;2021-02-26;5484114974;NYA CARNEGIE/21-02-24;-441.000;2021.990
2021-02-26;2021-02-26;5484756961;APOTEKSGRUPP/21-02-25;-5.180;2462.990
2021-02-26;2021-02-26;5490990789;46736227759;-400.000;2468.170
2021-02-24;2021-02-24;5490990004;PETER HENELL;2000.000;2868.170
2021-02-23;2021-02-23;5484459253;LIKOS THAI R/21-02-22;-135.000;868.170
2021-02-23;2021-02-23;5490990789;46709124799;357.000;1003.170
2021-02-22;2021-02-22;5484831279;COOP KONSUM /21-02-20;-80.350;646.170
2021-02-22;2021-02-22;5484110027;GOOGLE GOOGL/21-02-20;-19.000;726.520
2021-02-22;2021-02-22;5490990789;1234557674;-95.000;745.520
2021-02-22;2021-02-20;5484775509;BERGSHAMRA P/21-02-19;-85.000;840.520
2021-02-22;2021-02-20;5484138250;SYSTEMBOLAGE/21-02-19;-491.200;925.520
2021-02-22;2021-02-20;5484744793;HEMKÖP MÖRBY/21-02-19;-408.650;1416.720
2021-02-19;2021-02-19;5484772273;BELLISIMO   /21-02-18;-90.000;1825.370
2021-02-15;2021-02-15;5484744134;TZATSIKI RES/21-02-13;-285.000;1915.370
2021-02-15;2021-02-15;5484237085;HEMKÖP CITY /21-02-13;-77.270;2200.370
2021-02-15;2021-02-15;5484104467;BASTARD BURG/21-02-14;-445.000;2277.640
2021-02-12;2021-02-12;5484442599;BERGSHAMRA P/21-02-11;-109.000;2722.640
2021-02-05;2021-02-05;5490990004;PETER HENELL;2000.000;2831.640
2021-02-04;2021-02-04;5484567602;COOP KONSUM /21-02-02;-107.350;831.640
2021-02-03;2021-02-03;5484508322;BELLISIMO   /21-02-02;-95.000;938.990
2021-02-01;2021-01-30;5484604099;BERGSHAMRA P/21-01-29;-99.000;1033.990
2021-02-01;2021-01-30;5484864191;SYSTEMBOLAGE/21-01-29;-642.600;1132.990
2021-02-01;2021-01-30;5484585271;HEMKÖP MÖRBY/21-01-29;-456.400;1775.590
2021-01-29;2021-01-29;5484065348;BERGSHAMRA P/21-01-28;-95.000;2231.990
2021-01-25;2021-01-25;5484199619;ALEWALDS SPO/21-01-23;-798.000;2326.990
2021-01-25;2021-01-25;5484770223;COOP KONSUM /21-01-22;-54.820;3124.990
2021-01-25;2021-01-23;5490990004;PETER HENELL;3000.000;3179.810
2021-01-22;2021-01-22;5484507657;GOOGLE  GOOG/21-01-21;-19.000;179.810
2021-01-22;2021-01-22;5484029212;APOTEKSGRUPP/21-01-21;-11.460;198.810
2021-01-22;2021-01-22;5484863907;BELLISIMO   /21-01-21;-95.000;210.270
2021-01-18;2021-01-16;5484180027;RESTAURANG S/21-01-15;-583.000;305.270
2021-01-18;2021-01-16;5484159917;BELLISIMO   /21-01-15;-95.000;888.270
2021-01-14;2021-01-14;5484471121;RESTAURANG S/21-01-13;-824.000;983.270
2021-01-14;2021-01-14;5490990789;46736227759;400.000;1807.270
2021-01-11;2021-01-09;5484654837;BERGSHAMRA P/21-01-08;-180.000;1407.270
2021-01-11;2021-01-09;5484312502;SYSTEMBOLAGE/21-01-08;-672.000;1587.270
2021-01-11;2021-01-09;5484289396;APOTEKET EKE/21-01-08;-200.900;2259.270
2021-01-11;2021-01-09;5484072748;HEMKÖP MÖRBY/21-01-08;-52.900;2460.170
2021-01-05;2021-01-05;5484875398;OKQ8        /21-01-03;-400.000;2513.070
2021-01-05;2021-01-05;5484704213;HEMKÖP MÖRBY/21-01-04;-6.500;2913.070
2021-01-05;2021-01-05;5484704212;HEMKÖP MÖRBY/21-01-04;-137.700;2919.570
2021-01-04;2021-01-04;5484417816;ICA SUPERMAR/21-01-02;-23.900;3057.270
2020-12-28;2020-12-28;5484474011;COOP KONSUM /20-12-26;-86.850;3081.170
2020-12-28;2020-12-26;5484839574;APOTEK HJART/20-12-25;-307.900;3168.020
2020-12-23;2020-12-23;5484768914;BERGSHAMRA P/20-12-22;-79.000;3475.920
2020-12-23;2020-12-23;5484364128;BERGSHAMRA K/20-12-22;-450.000;3554.920
2020-12-22;2020-12-22;5484341252;COOP KONSUM /20-12-20;-79.110;4004.920
2020-12-22;2020-12-22;5484204380;GOOGLE  GOOG/20-12-21;-19.000;4084.030
2020-12-21;2020-12-21;5484684536;COOP KONSUM /20-12-18;-14.400;4103.030
2020-12-21;2020-12-19;5484527307;COOP KONSUM /20-12-17;-16.500;4117.430
2020-12-21;2020-12-19;5484650369;FESTINGBATEN/20-12-18;-410.000;4133.930
2020-12-21;2020-12-19;5484413579;STORA VIKING/20-12-18;-286.000;4543.930
2020-12-21;2020-12-19;5484241985;ICA SUPERMAR/20-12-18;-118.700;4829.930
2020-12-18;2020-12-18;5484094317;SYSTEMBOLAGE/20-12-17;-954.000;4948.630
2020-12-18;2020-12-18;5490990789;46702804339;1000.000;5902.630
2020-12-17;2020-12-17;5484361469;BELLISIMO   /20-12-16;-95.000;4902.630
2020-12-17;2020-12-17;5484201747;ICA NARA BER/20-12-16;-61.200;4997.630
2020-12-17;2020-12-17;5490990004;PETER HENELL;3000.000;5058.830
2020-12-14;2020-12-14;5484745386;UTO VARDSHUS/20-12-12;-1695.000;2058.830
2020-12-14;2020-12-12;5484296289;ICA SUPERMAR/20-12-11;-274.620;3753.830
2020-12-14;2020-12-12;5490990004;PETER HENELL;2000.000;4028.450
2020-12-10;2020-12-10;5484860831;BELLISIMO   /20-12-09;-95.000;2028.450
2020-12-07;2020-12-07;5484510169;HARSTYLISTER/20-12-05;-365.000;2123.450
2020-12-07;2020-12-07;5484270422;ICA SUPERMAR/20-12-05;-124.490;2488.450
2020-12-07;2020-12-06;5490990789;APOTEKET AB;-139.900;2612.940
2020-12-07;2020-12-05;5484579036;BELLISIMO   /20-12-04;-109.000;2752.840
2020-12-04;2020-12-04;5484515288;BERGSHAMRA P/20-12-03;-85.000;2861.840
2020-11-30;2020-11-30;5484532221;VASKTORGET  /20-11-29;-499.000;2946.840
2020-11-27;2020-11-27;5484186596;BELLISIMO   /20-11-26;-70.000;3445.840
2020-11-26;2020-11-26;5484371114;APOTEKSGRUPP/20-11-25;-97.750;3515.840
2020-11-26;2020-11-26;5484362461;APOTEK HJART/20-11-25;-20.690;3613.590
2020-11-26;2020-11-26;5484331017;BELLISIMO   /20-11-25;-95.000;3634.280
2020-11-25;2020-11-25;5484836238;SYSTRARNA P /20-11-24;-1987.500;3729.280
2020-11-25;2020-11-25;5490990004;PETER HENELL;3000.000;5716.780
2020-11-24;2020-11-24;5490990004;PETER HENELL;1500.000;2716.780
2020-11-23;2020-11-23;5484124516;CERVERA SVEA/20-11-21;-98.000;1216.780
2020-11-23;2020-11-23;5484124515;CERVERA SVEA/20-11-21;-599.000;1314.780
2020-11-23;2020-11-23;5484105019;GOOGLE  GOOG/20-11-21;-19.000;1913.780
2020-11-23;2020-11-23;5484872582;SYSTEMBOLAGE/20-11-21;-169.000;1932.780
2020-11-23;2020-11-23;5484524303;COOP KONSUM /20-11-21;-163.840;2101.780
2020-11-23;2020-11-23;5484524095;COOP KONSUM /20-11-20;-224.280;2265.620
2020-11-23;2020-11-23;5484173559;CLAS OHLSON /20-11-21;-582.400;2489.900
2020-11-16;2020-11-14;5484536239;HEMKÖP MÖRBY/20-11-13;-766.050;3072.300
2020-11-13;2020-11-13;5484365993;RESTAURANG P/20-11-12;-79.000;3838.350
2020-11-12;2020-11-12;5484160816;BELLISIMO   /20-11-11;-95.000;3917.350
2020-11-12;2020-11-12;5484371515;BASTARD BURG/20-11-11;-114.000;4012.350
2020-11-11;2020-11-11;5484129747;HAIKKY SUSHI/20-11-10;-120.000;4126.350
2020-11-10;2020-11-10;5484547164;BERGSHAMRA P/20-11-09;-79.000;4246.350
2020-11-09;2020-11-09;5484056028;LIKOS THAI R/20-11-06;-198.000;4325.350
2020-11-09;2020-11-09;5484401360;COOP KONSUM /20-11-06;-131.200;4523.350
2020-11-09;2020-11-07;5484252056;BERGSHAMRA P/20-11-06;-79.000;4654.550
2020-11-06;2020-11-06;5490990004;PETER HENELL;2000.000;4733.550
2020-11-06;2020-11-06;5484321542;BELLISIMO   /20-11-05;-95.000;2733.550
2020-11-04;2020-11-04;5484313426;BELLISIMO   /20-11-03;-95.000;2828.550
2020-11-03;2020-11-03;5484010999;LIKOS THAI R/20-11-02;-99.000;2923.550
2020-11-02;2020-11-02;5484103321;WILLYS STOCK/20-10-31;-64.300;3022.550
2020-11-02;2020-10-31;5484116112;WILLYS STOCK/20-10-30;-80.600;3086.850
2020-10-30;2020-10-30;5484294507;THE BISHOP  /20-10-29;-176.000;3167.450
2020-10-30;2020-10-30;5484294500;THE BISHOP  /20-10-29;-277.000;3343.450
2020-10-29;2020-10-29;5490990789;46702883040;-350.000;3620.450
2020-10-29;2020-10-29;5490990004;PETER HENELL;3000.000;3970.450
2020-10-26;2020-10-26;5484542825;POLISMUSEET /20-10-24;-120.000;970.450
2020-10-26;2020-10-26;5484464542;VETE-KATTEN /20-10-24;-26.000;1090.450
2020-10-26;2020-10-24;5484714978;WILLYS STOCK/20-10-23;-162.200;1116.450
2020-10-23;2020-10-23;5484630662;APOTEKSGRUPP/20-10-22;-308.850;1278.650
2020-10-23;2020-10-23;5484589632;BELLISIMO   /20-10-22;-165.000;1587.500
2020-10-23;2020-10-23;5484278405;BERGSHAMRA P/20-10-22;-79.000;1752.500
2020-10-23;2020-10-23;5490990789;46721428359;-100.000;1831.500
2020-10-22;2020-10-22;5484317627;GOOGLE  GOOG/20-10-21;-19.000;1931.500
2020-10-20;2020-10-20;5484795530;RESTAURANG E/20-10-19;-24.000;1950.500
2020-10-20;2020-10-20;5484510291;BERGSHAMRA P/20-10-19;-79.000;1974.500
2020-10-16;2020-10-16;5484110708;BERGSHAMRA P/20-10-15;-85.000;2053.500
2020-10-14;2020-10-14;5484244954;BELLISIMO   /20-10-13;-95.000;2138.500
2020-10-12;2020-10-12;5484513760;SPEED SERVIC/20-10-10;-120.000;2233.500
2020-10-12;2020-10-12;5484233585;SYSTEMBOLAGE/20-10-10;-437.400;2353.500
2020-10-12;2020-10-12;5484838575;HEMKÖP MÖRBY/20-10-10;-274.010;2790.900
2020-10-12;2020-10-12;5484797181;COOP KONSUM /20-10-09;-222.170;3064.910
2020-10-06;2020-10-06;5484817088;COOP KONSUM /20-10-04;-7.950;3287.080
2020-10-05;2020-10-05;5484306197;COOP KONSUM /20-10-02;-166.820;3295.030
2020-10-05;2020-10-05;5484165235;WHOELSE     /20-10-04;-300.000;3461.850
2020-10-05;2020-10-03;5484792028;BERGSHAMRA P/20-10-02;-79.000;3761.850
2020-10-05;2020-10-03;5484346421;APOTEKSGRUPP/20-10-02;-52.000;3840.850
2020-10-02;2020-10-02;5490990004;PETER HENELL;3000.000;3892.850
2020-09-30;2020-09-30;5484661594;COOP KONSUM /20-09-28;-78.100;892.850
2020-09-28;2020-09-28;5484486818;STORA VIKING/20-09-26;-367.000;970.950
2020-09-28;2020-09-28;5484202659;COOP KONSUM /20-09-25;-19.950;1337.950
2020-09-28;2020-09-28;5490990789;46709124799;-400.000;1357.900
2020-09-28;2020-09-26;5484536661;BERGSHAMRA B/20-09-25;-205.000;1757.900
2020-09-28;2020-09-26;5484221611;RESTAURANG E/20-09-25;-150.000;1962.900
2020-09-28;2020-09-26;5484848493;APOTEK HJART/20-09-25;-34.900;2112.900
2020-09-25;2020-09-25;5484027058;BELLISIMO   /20-09-24;-95.000;2147.800
2020-09-24;2020-09-24;5484049458;BERGSHAMRA P/20-09-23;-85.000;2242.800
2020-09-23;2020-09-23;5484513307;GOOGLE GOOGL/20-09-20;-19.000;2327.800
2020-09-23;2020-09-23;5484402166;BERGSHAMRA P/20-09-22;-79.000;2346.800
2020-09-21;2020-09-21;5484820792;HARSTYLISTER/20-09-19;-991.000;2425.800
2020-09-21;2020-09-21;5484786053;SYSTEMBOLAGE/20-09-19;-413.100;3416.800
2020-09-21;2020-09-19;5490990789;46709124799;330.000;3829.900
2020-09-17;2020-09-17;5484753945;COOP KONSUM /20-09-15;-35.900;3499.900
2020-09-14;2020-09-14;5484089238;COOP KONSUM /20-09-12;-165.450;3535.800
2020-09-14;2020-09-14;5484788861;BERGSHAMRA P/20-09-12;-170.000;3701.250
2020-09-11;2020-09-11;5484030861;ICA NARA BER/20-09-10;-46.900;3871.250
2020-09-08;2020-09-08;5484169451;HORNBACH BYG/20-09-07;-383.900;3918.150
2020-09-07;2020-09-07;5484851076;GNARLY KUNGS/20-09-04;-452.000;4302.050
2020-09-07;2020-09-07;5484606980;COOP KONSUM /20-09-05;-45.130;4754.050
2020-09-07;2020-09-07;5484606818;COOP KONSUM /20-09-04;-70.100;4799.180
2020-09-04;2020-09-04;5484600600;BELLISIMO   /20-09-03;-99.000;4869.280
2020-09-03;2020-09-03;5484571575;WILLYS STOCK/20-09-02;-14.500;4968.280
2020-09-02;2020-09-02;5484294221;BELLISIMO   /20-09-01;-80.000;4982.780
2020-09-01;2020-09-01;5484878725;BERGSHAMRA P/20-08-31;-158.000;5062.780
2020-08-31;2020-08-31;5484142932;FILMSTADEN H/20-08-29;-56.000;5220.780
2020-08-31;2020-08-31;5484111414;ALEWALDS SPO/20-08-29;-354.200;5276.780
2020-08-31;2020-08-31;5484039440;KUNGENS KURV/20-08-29;-95.000;5630.980
2020-08-31;2020-08-31;5484403000;ALEWALDS SPO/20-08-30;-5674.200;5725.980
2020-08-31;2020-08-31;5490990789;46768847083;80.000;11400.180
2020-08-31;2020-08-30;5490990004;PETER HENELL;5500.000;11320.180
2020-08-24;2020-08-22;5484395387;GOOGLE  GOOG/20-08-21;-19.000;5820.180
2020-08-24;2020-08-22;5484151913;HEMKÖP MÖRBY/20-08-21;-283.670;5839.180
2020-08-21;2020-08-21;5490990004;PETER HENELL;6000.000;6122.850
